Geography,Total Population,White,Black or African American,American Indian and Alaska Native,Asian,Native Hawaiian and Other Pacific Islander,Some other race,Total population,Hispanic or Latino (of any race),Not Latino,One Race,Two or More Races
"Aitkin city, Aitkin County, Minnesota",2171,2106,73,54,17,0,0,2171,51,2120,2095,76
"Aitkin township, Aitkin County, Minnesota",975,968,5,4,2,0,1,975,9,966,970,5
"Ball Bluff township, Aitkin County, Minnesota",227,227,0,0,0,0,0,227,6,221,227,0
"Balsam township, Aitkin County, Minnesota",35,35,0,0,0,0,0,35,0,35,35,0
"Beaver township, Aitkin County, Minnesota",54,54,0,0,0,0,0,54,0,54,54,0
"Clark township, Aitkin County, Minnesota",158,151,0,7,0,0,0,158,0,158,158,0
"Cornish township, Aitkin County, Minnesota",32,32,0,0,0,0,0,32,5,27,32,0
"Davidson UT, Aitkin County, Minnesota",36,36,0,0,0,0,0,36,0,36,36,0
"Farm Island township, Aitkin County, Minnesota",1031,1031,0,6,0,0,0,1031,3,1028,1025,6
"Fleming township, Aitkin County, Minnesota",346,343,8,0,9,0,0,346,1,345,332,14
"Glen township, Aitkin County, Minnesota",436,436,0,4,4,0,0,436,0,436,432,4
"Haugen township, Aitkin County, Minnesota",185,185,0,0,0,0,0,185,0,185,185,0
"Hazelton township, Aitkin County, Minnesota",692,684,2,19,2,0,0,692,9,683,677,15
"Hill City city, Aitkin County, Minnesota",608,579,17,36,15,9,0,608,0,608,577,31
"Hill Lake township, Aitkin County, Minnesota",394,385,0,9,0,0,14,394,14,380,380,14
"Idun township, Aitkin County, Minnesota",246,245,0,1,0,0,0,246,0,246,246,0
"Jevne township, Aitkin County, Minnesota",336,324,0,5,9,0,0,336,0,336,334,2
"Jewett UT, Aitkin County, Minnesota",70,70,0,0,0,0,0,70,0,70,70,0
"Kimberly township, Aitkin County, Minnesota",170,166,0,0,0,0,4,170,4,166,170,0
"Lakeside township, Aitkin County, Minnesota",390,390,0,2,0,0,0,390,0,390,388,2
"Lee township, Aitkin County, Minnesota",25,25,0,0,0,0,0,25,1,24,25,0
"Libby township, Aitkin County, Minnesota",63,59,0,4,0,0,0,63,0,63,63,0
"Logan township, Aitkin County, Minnesota",196,196,0,3,0,0,0,196,0,196,193,3
"McGrath city, Aitkin County, Minnesota",60,60,0,0,0,0,0,60,6,54,60,0
"McGregor city, Aitkin County, Minnesota",421,386,26,33,2,2,0,421,0,421,393,28
"McGregor township, Aitkin County, Minnesota",134,134,0,0,0,0,0,134,0,134,134,0
"Macville township, Aitkin County, Minnesota",169,160,0,9,0,0,0,169,0,169,169,0
"Malmo township, Aitkin County, Minnesota",313,307,4,20,5,0,0,313,0,313,290,23
"Millward township, Aitkin County, Minnesota",68,62,7,0,0,0,0,68,0,68,67,1
"Morrison township, Aitkin County, Minnesota",186,176,10,0,0,0,0,186,0,186,186,0
"Nordland township, Aitkin County, Minnesota",977,967,0,8,2,0,0,977,16,961,977,0
"Northeast Aitkin UT, Aitkin County, Minnesota",0,0,0,0,0,0,0,0,0,0,0,0
"Northwest Aitkin UT, Aitkin County, Minnesota",248,246,0,20,0,0,0,248,0,248,230,18
"Palisade city, Aitkin County, Minnesota",213,169,0,42,5,0,0,213,0,213,210,3
"Pliny township, Aitkin County, Minnesota",122,122,0,0,0,0,0,122,0,122,122,0
"Rice River township, Aitkin County, Minnesota",103,103,0,0,0,0,0,103,0,103,103,0
"Salo township, Aitkin County, Minnesota",84,84,0,3,0,0,0,84,0,84,81,3
"Seavey township, Aitkin County, Minnesota",66,66,0,0,0,0,0,66,0,66,66,0
"Shamrock township, Aitkin County, Minnesota",1398,1358,13,45,0,0,0,1398,68,1330,1380,18
"Spalding township, Aitkin County, Minnesota",278,158,0,124,0,0,0,278,2,276,274,4
"Spencer township, Aitkin County, Minnesota",536,516,0,0,20,0,0,536,0,536,536,0
"Tamarack city, Aitkin County, Minnesota",86,81,5,0,0,0,0,86,0,86,86,0
"Turner township, Aitkin County, Minnesota",193,153,3,37,0,0,0,193,0,193,193,0
"Verdon township, Aitkin County, Minnesota",38,38,0,0,0,0,0,38,0,38,38,0
"Wagner township, Aitkin County, Minnesota",290,290,0,1,0,0,0,290,1,289,289,1
"Waukenabo township, Aitkin County, Minnesota",327,325,0,0,0,2,0,327,0,327,327,0
"Wealthwood township, Aitkin County, Minnesota",261,259,0,9,0,0,0,261,6,255,254,7
"White Pine township, Aitkin County, Minnesota",22,22,0,0,0,0,0,22,0,22,22,0
"Williams township, Aitkin County, Minnesota",141,141,0,4,0,0,0,141,0,141,137,4
"Workman township, Aitkin County, Minnesota",231,223,0,3,5,0,0,231,0,231,231,0
"Andover city, Anoka County, Minnesota",32257,30409,1470,242,928,10,257,32257,993,31264,31346,911
"Anoka city, Anoka County, Minnesota",17374,15284,1637,408,380,6,382,17374,744,16630,16716,658
"Bethel city, Anoka County, Minnesota",467,464,3,0,11,0,1,467,22,445,455,12
"Blaine city, Anoka County, Minnesota",62453,52723,3931,824,5461,165,1208,62453,2543,59910,60670,1783
"Centerville city, Anoka County, Minnesota",3943,3770,7,107,232,7,17,3943,84,3859,3753,190
"Circle Pines city, Anoka County, Minnesota",4967,4540,167,261,396,12,23,4967,88,4879,4615,352
"Columbia Heights city, Anoka County, Minnesota",19823,13530,4120,561,1253,35,1392,19823,2026,17797,18844,979
"Columbus city, Anoka County, Minnesota",4009,3700,17,113,201,0,18,4009,50,3959,3969,40
"Coon Rapids city, Anoka County, Minnesota",62342,55091,4731,583,2949,82,995,62342,2422,59920,60350,1992
"East Bethel city, Anoka County, Minnesota",11733,11425,30,152,361,0,54,11733,73,11660,11460,273
"Fridley city, Anoka County, Minnesota",27573,19660,4762,649,1984,30,1494,27573,2841,24732,26635,938
"Ham Lake city, Anoka County, Minnesota",16119,15241,299,200,716,0,96,16119,269,15850,15696,423
"Hilltop city, Anoka County, Minnesota",886,522,107,43,50,0,254,886,340,546,801,85
"Lexington city, Anoka County, Minnesota",1938,1686,135,28,170,4,0,1938,61,1877,1863,75
"Lino Lakes city, Anoka County, Minnesota",20950,19765,589,368,628,0,275,20950,514,20436,20359,591
"Linwood township, Anoka County, Minnesota",5341,5234,108,82,19,0,27,5341,54,5287,5228,113
"Nowthen city, Anoka County, Minnesota",4612,4163,11,175,141,0,140,4612,194,4418,4594,18
"Oak Grove city, Anoka County, Minnesota",8453,8023,222,40,288,0,45,8453,184,8269,8288,165
"Ramsey city, Anoka County, Minnesota",25853,24267,721,183,1106,7,239,25853,574,25279,25213,640
"St. Francis city, Anoka County, Minnesota",7475,7355,61,176,200,24,36,7475,70,7405,7098,377
"Spring Lake Park city, Anoka County, Minnesota",6293,5311,540,191,437,113,271,6293,451,5842,5804,489
"Atlanta township, Becker County, Minnesota",97,94,0,0,0,4,0,97,5,92,96,1
"Audubon city, Becker County, Minnesota",546,489,0,69,3,0,0,546,4,542,531,15
"Audubon township, Becker County, Minnesota",548,531,1,26,0,0,13,548,3,545,525,23
"Burlington township, Becker County, Minnesota",1582,1503,7,59,8,1,31,1582,46,1536,1555,27
"Callaway city, Becker County, Minnesota",216,98,0,124,0,0,0,216,2,214,210,6
"Callaway township, Becker County, Minnesota",314,232,2,113,5,1,4,314,17,297,271,43
"Carsonville township, Becker County, Minnesota",196,184,0,14,0,0,0,196,0,196,194,2
"Cormorant township, Becker County, Minnesota",1182,1179,0,0,4,0,0,1182,28,1154,1181,1
"Cuba township, Becker County, Minnesota",332,328,2,0,0,0,2,332,14,318,332,0
"Detroit township, Becker County, Minnesota",2220,2024,0,220,15,3,0,2220,45,2175,2178,42
"Detroit Lakes city, Becker County, Minnesota",9078,8483,217,605,123,17,17,9078,170,8908,8703,375
"Eagle View township, Becker County, Minnesota",162,110,0,55,1,0,0,162,0,162,158,4
"Erie township, Becker County, Minnesota",1921,1852,8,108,0,0,21,1921,76,1845,1853,68
"Evergreen township, Becker County, Minnesota",411,411,0,1,0,0,0,411,14,397,410,1
"Forest township, Becker County, Minnesota",109,109,0,5,0,0,0,109,4,105,104,5
"Frazee city, Becker County, Minnesota",1294,1218,12,72,22,0,0,1294,12,1282,1264,30
"Green Valley township, Becker County, Minnesota",378,375,1,12,0,0,0,378,5,373,368,10
"Hamden township, Becker County, Minnesota",168,168,0,0,0,0,0,168,2,166,168,0
"Height of Land township, Becker County, Minnesota",536,529,1,15,0,0,0,536,7,529,527,9
"Holmesville township, Becker County, Minnesota",597,527,4,73,42,0,0,597,35,562,548,49
"Lake Eunice township, Becker County, Minnesota",1429,1373,42,46,16,0,12,1429,12,1417,1369,60
"Lake Park city, Becker County, Minnesota",776,740,2,46,0,0,3,776,15,761,761,15
"Lake Park township, Becker County, Minnesota",470,467,0,8,0,0,5,470,5,465,460,10
"Lake View township, Becker County, Minnesota",1853,1844,6,73,0,0,0,1853,12,1841,1783,70
"Maple Grove township, Becker County, Minnesota",421,202,3,247,0,3,0,421,0,421,387,34
"Ogema city, Becker County, Minnesota",192,83,6,119,2,0,2,192,12,180,172,20
"Osage township, Becker County, Minnesota",748,741,3,18,0,0,2,748,6,742,732,16
"Pine Point township, Becker County, Minnesota",441,76,0,358,12,0,4,441,4,437,432,9
"Riceville township, Becker County, Minnesota",92,90,0,2,0,0,0,92,2,90,92,0
"Richwood township, Becker County, Minnesota",581,567,3,43,0,0,0,581,0,581,549,32
"Round Lake township, Becker County, Minnesota",118,75,0,43,0,0,0,118,0,118,118,0
"Runeberg township, Becker County, Minnesota",596,589,4,12,0,0,8,596,20,576,581,15
"Savannah township, Becker County, Minnesota",155,153,0,3,0,0,0,155,0,155,154,1
"Shell Lake township, Becker County, Minnesota",288,275,0,17,0,0,0,288,0,288,284,4
"Silver Leaf township, Becker County, Minnesota",471,466,13,10,0,0,0,471,0,471,453,18
"Spring Creek township, Becker County, Minnesota",125,89,0,36,0,0,0,125,0,125,125,0
"Spruce Grove township, Becker County, Minnesota",356,350,1,6,0,0,2,356,0,356,353,3
"Sugar Bush township, Becker County, Minnesota",508,383,0,154,0,0,0,508,4,504,479,29
"Toad Lake township, Becker County, Minnesota",651,651,0,2,0,1,0,651,0,651,648,3
"Two Inlets township, Becker County, Minnesota",312,312,0,3,0,0,0,312,0,312,309,3
"Walworth township, Becker County, Minnesota",81,80,0,0,6,0,0,81,0,81,76,5
"White Earth township, Becker County, Minnesota",770,210,0,584,7,0,9,770,53,717,730,40
"Wolf Lake city, Becker County, Minnesota",18,17,1,0,0,0,0,18,0,18,18,0
"Wolf Lake township, Becker County, Minnesota",213,211,0,0,0,1,1,213,1,212,213,0
"Alaska township, Beltrami County, Minnesota",220,217,0,4,0,0,4,220,3,217,215,5
"Battle township, Beltrami County, Minnesota",91,79,0,16,9,0,0,91,0,91,78,13
"Bemidji city, Beltrami County, Minnesota",14803,12478,398,2528,207,0,0,14803,220,14583,13995,808
"Bemidji township, Beltrami County, Minnesota",3499,3195,116,246,0,11,0,3499,43,3456,3437,62
"Benville township, Beltrami County, Minnesota",83,82,0,0,1,0,0,83,0,83,83,0
"Birch township, Beltrami County, Minnesota",66,64,0,8,0,0,0,66,0,66,60,6
"Blackduck city, Beltrami County, Minnesota",821,726,12,85,7,0,22,821,28,793,790,31
"Brook Lake UT, Beltrami County, Minnesota",181,104,0,77,0,0,0,181,0,181,181,0
"Buzzle township, Beltrami County, Minnesota",241,239,8,2,0,0,0,241,0,241,233,8
"Cormant township, Beltrami County, Minnesota",156,156,0,0,0,0,0,156,0,156,156,0
"Durand township, Beltrami County, Minnesota",216,199,0,22,0,0,0,216,0,216,211,5
"Eckles township, Beltrami County, Minnesota",1511,1301,3,221,6,3,21,1511,45,1466,1467,44
"Frohn township, Beltrami County, Minnesota",1422,1260,5,192,19,0,0,1422,3,1419,1368,54
"Funkley city, Beltrami County, Minnesota",6,6,0,0,0,0,0,6,0,6,6,0
"Grant Valley township, Beltrami County, Minnesota",2405,2108,6,263,27,19,58,2405,112,2293,2329,76
"Hagali township, Beltrami County, Minnesota",328,324,0,2,4,0,0,328,4,324,326,2
"Hamre township, Beltrami County, Minnesota",8,8,0,0,0,0,0,8,0,8,8,0
"Hines township, Beltrami County, Minnesota",576,565,0,19,0,0,0,576,27,549,568,8
"Hornet township, Beltrami County, Minnesota",210,192,3,30,0,0,0,210,0,210,195,15
"Jones township, Beltrami County, Minnesota",153,149,0,6,2,0,0,153,0,153,149,4
"Kelliher city, Beltrami County, Minnesota",266,244,0,22,0,0,0,266,6,260,266,0
"Kelliher township, Beltrami County, Minnesota",120,107,0,29,0,0,0,120,0,120,104,16
"Lammers township, Beltrami County, Minnesota",655,643,5,19,8,0,0,655,52,603,641,14
"Langor township, Beltrami County, Minnesota",172,167,0,7,1,0,0,172,0,172,169,3
"Lee township, Beltrami County, Minnesota",35,34,0,0,3,0,0,35,0,35,33,2
"Liberty township, Beltrami County, Minnesota",657,628,3,18,15,0,0,657,17,640,650,7
"Lower Red Lake UT, Beltrami County, Minnesota",5798,287,47,5508,44,0,0,5798,146,5652,5710,88
"Maple Ridge township, Beltrami County, Minnesota",125,109,0,20,0,0,0,125,3,122,121,4
"Minnie township, Beltrami County, Minnesota",25,25,0,0,0,0,0,25,0,25,25,0
"Moose Lake township, Beltrami County, Minnesota",225,218,0,9,0,0,0,225,9,216,223,2
"Nebish township, Beltrami County, Minnesota",293,285,3,10,0,0,0,293,0,293,288,5
"North Beltrami UT, Beltrami County, Minnesota",63,60,0,11,0,0,0,63,8,55,55,8
"Northern township, Beltrami County, Minnesota",4108,3758,79,313,90,0,41,4108,165,3943,3935,173
"O'Brien township, Beltrami County, Minnesota",19,19,0,0,0,0,0,19,0,19,19,0
"Port Hope township, Beltrami County, Minnesota",618,605,2,32,0,0,4,618,4,614,593,25
"Quiring township, Beltrami County, Minnesota",94,77,17,0,0,0,0,94,0,94,94,0
"Roosevelt township, Beltrami County, Minnesota",234,194,0,44,0,37,0,234,0,234,193,41
"Shooks township, Beltrami County, Minnesota",139,139,0,0,0,0,0,139,0,139,139,0
"Shotley township, Beltrami County, Minnesota",30,30,0,0,0,0,0,30,0,30,30,0
"Shotley Brook UT, Beltrami County, Minnesota",11,11,0,0,0,0,0,11,0,11,11,0
"Solway city, Beltrami County, Minnesota",62,62,0,0,1,0,5,62,5,57,56,6
"Spruce Grove township, Beltrami County, Minnesota",45,45,0,0,0,0,0,45,0,45,45,0
"Steenerson township, Beltrami County, Minnesota",31,22,0,6,4,0,0,31,4,27,30,1
"Sugar Bush township, Beltrami County, Minnesota",405,334,31,54,5,0,3,405,0,405,389,16
"Summit township, Beltrami County, Minnesota",265,265,0,0,0,0,0,265,0,265,265,0
"Taylor township, Beltrami County, Minnesota",117,117,0,3,1,0,0,117,0,117,113,4
"Ten Lake township, Beltrami County, Minnesota",1135,308,24,790,16,21,0,1135,87,1048,1121,14
"Tenstrike city, Beltrami County, Minnesota",189,183,6,1,0,0,0,189,0,189,188,1
"Turtle Lake township, Beltrami County, Minnesota",1249,1233,6,28,8,0,0,1249,8,1241,1223,26
"Turtle River city, Beltrami County, Minnesota",94,94,0,0,0,0,0,94,0,94,94,0
"Turtle River township, Beltrami County, Minnesota",1222,1145,6,89,17,0,0,1222,14,1208,1187,35
"Upper Red Lake UT, Beltrami County, Minnesota",12,4,0,8,0,0,0,12,0,12,12,0
"Waskish township, Beltrami County, Minnesota",88,88,0,0,0,0,0,88,0,88,88,0
"Wilton city, Beltrami County, Minnesota",179,173,8,4,0,0,3,179,5,174,170,9
"Woodrow township, Beltrami County, Minnesota",71,71,0,0,0,0,0,71,0,71,71,0
"Alberta township, Benton County, Minnesota",744,744,4,1,0,0,0,744,0,744,739,5
"Foley city, Benton County, Minnesota",2633,2582,52,21,0,0,24,2633,63,2570,2590,43
"Gilman city, Benton County, Minnesota",223,209,0,1,0,0,14,223,14,209,222,1
"Gilmanton township, Benton County, Minnesota",801,801,5,0,36,0,0,801,3,798,760,41
"Glendorado township, Benton County, Minnesota",732,728,2,25,0,0,0,732,20,712,709,23
"Graham township, Benton County, Minnesota",610,602,4,3,0,1,3,610,4,606,607,3
"Granite Ledge township, Benton County, Minnesota",718,701,0,8,11,0,2,718,13,705,714,4
"Langola township, Benton County, Minnesota",1070,1051,1,10,52,0,0,1070,64,1006,1027,43
"Mayhew Lake township, Benton County, Minnesota",826,820,0,2,13,0,0,826,0,826,817,9
"Maywood township, Benton County, Minnesota",925,916,6,32,9,0,0,925,21,904,893,32
"Minden township, Benton County, Minnesota",1701,1686,0,15,0,0,0,1701,15,1686,1701,0
"Rice city, Benton County, Minnesota",1575,1557,43,5,10,0,0,1575,15,1560,1535,40
"Royalton city, Benton County, Minnesota",0,0,0,0,0,0,0,0,0,0,0,0
"St. Cloud city, Benton County, Minnesota",6476,5353,1097,183,68,0,14,6476,186,6290,6237,239
"St. George township, Benton County, Minnesota",1201,1196,5,0,0,0,0,1201,5,1196,1201,0
"Sartell city, Benton County, Minnesota",2093,2032,67,0,0,0,0,2093,58,2035,2087,6
"Sauk Rapids city, Benton County, Minnesota",13354,13018,241,77,350,0,13,13354,344,13010,13009,345
"Sauk Rapids township, Benton County, Minnesota",544,525,2,2,15,0,0,544,6,538,544,0
"Watab township, Benton County, Minnesota",3134,3116,11,21,69,0,0,3134,21,3113,3059,75
"Akron township, Big Stone County, Minnesota",181,181,0,0,0,0,0,181,0,181,181,0
"Almond township, Big Stone County, Minnesota",138,138,0,0,0,0,0,138,0,138,138,0
"Artichoke township, Big Stone County, Minnesota",53,53,0,0,0,0,0,53,0,53,53,0
"Barry city, Big Stone County, Minnesota",4,4,0,0,0,0,0,4,0,4,4,0
"Beardsley city, Big Stone County, Minnesota",204,203,0,0,0,0,1,204,5,199,204,0
"Big Stone township, Big Stone County, Minnesota",298,298,0,11,0,0,0,298,3,295,287,11
"Browns Valley township, Big Stone County, Minnesota",60,60,0,0,0,0,0,60,0,60,60,0
"Clinton city, Big Stone County, Minnesota",349,349,0,0,0,0,0,349,0,349,349,0
"Correll city, Big Stone County, Minnesota",44,44,0,0,0,0,0,44,0,44,44,0
"Foster township, Big Stone County, Minnesota",133,133,0,0,0,0,0,133,0,133,133,0
"Graceville city, Big Stone County, Minnesota",655,649,6,0,0,0,0,655,0,655,655,0
"Graceville township, Big Stone County, Minnesota",164,164,0,0,0,0,0,164,0,164,164,0
"Johnson city, Big Stone County, Minnesota",0,0,0,0,0,0,0,0,0,0,0,0
"Malta township, Big Stone County, Minnesota",108,108,0,0,0,0,0,108,0,108,108,0
"Moonshine township, Big Stone County, Minnesota",144,144,0,0,0,0,0,144,5,139,144,0
"Odessa city, Big Stone County, Minnesota",130,130,0,0,0,0,0,130,0,130,130,0
"Odessa township, Big Stone County, Minnesota",149,149,0,0,0,0,0,149,0,149,149,0
"Ortonville city, Big Stone County, Minnesota",1927,1918,9,9,0,0,0,1927,58,1869,1918,9
"Ortonville township, Big Stone County, Minnesota",74,74,0,0,0,0,0,74,0,74,74,0
"Otrey township, Big Stone County, Minnesota",46,46,0,0,0,0,0,46,0,46,46,0
"Prior township, Big Stone County, Minnesota",157,157,0,0,0,0,0,157,0,157,157,0
"Toqua township, Big Stone County, Minnesota",21,21,0,0,0,0,0,21,0,21,21,0
"Amboy city, Blue Earth County, Minnesota",744,744,10,4,0,0,0,744,77,667,730,14
"Beauford township, Blue Earth County, Minnesota",458,457,1,0,0,0,0,458,6,452,458,0
"Butternut Valley township, Blue Earth County, Minnesota",305,303,0,0,0,0,2,305,3,302,305,0
"Cambria township, Blue Earth County, Minnesota",239,238,0,1,0,0,0,239,0,239,239,0
"Ceresco township, Blue Earth County, Minnesota",184,183,33,4,0,0,5,184,5,179,147,37
"Danville township, Blue Earth County, Minnesota",223,220,0,2,3,0,0,223,3,220,221,2
"Decoria township, Blue Earth County, Minnesota",1242,1231,4,1,11,0,0,1242,6,1236,1237,5
"Eagle Lake city, Blue Earth County, Minnesota",2812,2573,280,15,19,6,0,2812,58,2754,2731,81
"Garden City township, Blue Earth County, Minnesota",821,806,0,12,0,2,6,821,6,815,816,5
"Good Thunder city, Blue Earth County, Minnesota",568,551,19,0,7,0,10,568,18,550,549,19
"Jamestown township, Blue Earth County, Minnesota",666,666,0,0,0,0,2,666,0,666,664,2
"Judson township, Blue Earth County, Minnesota",582,579,3,0,0,0,0,582,0,582,582,0
"Lake Crystal city, Blue Earth County, Minnesota",2430,2420,9,8,0,0,10,2430,34,2396,2413,17
"Le Ray township, Blue Earth County, Minnesota",744,725,11,0,28,0,3,744,6,738,721,23
"Lime township, Blue Earth County, Minnesota",995,982,46,0,0,0,3,995,7,988,959,36
"Lincoln township, Blue Earth County, Minnesota",208,205,0,0,3,0,0,208,4,204,208,0
"Lyra township, Blue Earth County, Minnesota",294,286,0,6,2,0,2,294,2,292,292,2
"McPherson township, Blue Earth County, Minnesota",417,412,5,0,0,0,0,417,0,417,417,0
"Madison Lake city, Blue Earth County, Minnesota",957,931,19,0,7,0,0,957,15,942,957,0
"Mankato city, Blue Earth County, Minnesota",41241,37683,2435,332,1718,38,261,41241,1572,39669,40066,1175
"Mankato township, Blue Earth County, Minnesota",1606,1579,7,4,23,0,0,1606,0,1606,1599,7
"Mapleton city, Blue Earth County, Minnesota",1634,1617,3,13,29,0,23,1634,48,1586,1590,44
"Mapleton township, Blue Earth County, Minnesota",352,352,12,0,0,0,0,352,41,311,340,12
"Medo township, Blue Earth County, Minnesota",352,349,2,2,0,0,0,352,2,350,351,1
"Minnesota Lake city, Blue Earth County, Minnesota",13,13,0,0,0,0,0,13,0,13,13,0
"North Mankato city, Blue Earth County, Minnesota",0,0,0,0,0,0,0,0,0,0,0,0
"Pemberton city, Blue Earth County, Minnesota",270,267,0,3,0,0,5,270,32,238,265,5
"Pleasant Mound township, Blue Earth County, Minnesota",232,232,0,0,0,0,0,232,2,230,232,0
"Rapidan township, Blue Earth County, Minnesota",1073,1070,2,0,19,0,0,1073,4,1069,1055,18
"St. Clair city, Blue Earth County, Minnesota",869,869,6,2,8,0,0,869,83,786,853,16
"Shelby township, Blue Earth County, Minnesota",282,277,0,4,9,0,0,282,0,282,274,8
"Skyline city, Blue Earth County, Minnesota",296,288,0,3,5,0,6,296,6,290,290,6
"South Bend township, Blue Earth County, Minnesota",1820,1707,128,6,3,0,0,1820,74,1746,1796,24
"Sterling township, Blue Earth County, Minnesota",286,270,1,0,15,0,0,286,0,286,286,0
"Vernon Center city, Blue Earth County, Minnesota",359,359,2,0,0,0,0,359,17,342,357,2
"Vernon Center township, Blue Earth County, Minnesota",193,185,8,3,0,0,2,193,0,193,188,5
"Albin township, Brown County, Minnesota",304,302,1,0,1,0,1,304,1,303,303,1
"Bashaw township, Brown County, Minnesota",217,217,0,0,0,0,0,217,0,217,217,0
"Burnstown township, Brown County, Minnesota",213,198,0,0,15,0,0,213,0,213,213,0
"Cobden city, Brown County, Minnesota",12,12,0,0,0,0,0,12,0,12,12,0
"Comfrey city, Brown County, Minnesota",320,315,0,0,5,0,0,320,17,303,320,0
"Cottonwood township, Brown County, Minnesota",895,895,0,0,0,0,0,895,3,892,895,0
"Eden township, Brown County, Minnesota",261,261,0,0,0,0,0,261,0,261,261,0
"Evan city, Brown County, Minnesota",64,64,0,1,0,0,0,64,1,63,63,1
"Hanska city, Brown County, Minnesota",419,418,0,0,0,0,1,419,11,408,419,0
"Home township, Brown County, Minnesota",448,448,0,0,0,0,0,448,1,447,448,0
"Lake Hanska township, Brown County, Minnesota",290,284,0,5,10,3,1,290,1,289,277,13
"Leavenworth township, Brown County, Minnesota",372,372,0,0,0,0,0,372,1,371,372,0
"Linden township, Brown County, Minnesota",301,300,0,0,0,0,4,301,4,297,298,3
"Milford township, Brown County, Minnesota",688,685,10,0,0,0,0,688,3,685,681,7
"Mulligan township, Brown County, Minnesota",172,170,2,0,0,0,0,172,0,172,172,0
"New Ulm city, Brown County, Minnesota",13249,12863,73,40,205,61,163,13249,487,12762,13093,156
"North Star township, Brown County, Minnesota",277,275,0,0,2,0,0,277,2,275,277,0
"Prairieville township, Brown County, Minnesota",277,277,0,0,0,0,0,277,0,277,277,0
"Sigel township, Brown County, Minnesota",398,389,0,0,15,0,0,398,0,398,392,6
"Sleepy Eye city, Brown County, Minnesota",3431,3129,21,0,6,0,281,3431,426,3005,3425,6
"Springfield city, Brown County, Minnesota",2105,2054,12,19,48,0,9,2105,70,2035,2068,37
"Stark township, Brown County, Minnesota",360,358,0,0,0,0,2,360,2,358,360,0
"Stately township, Brown County, Minnesota",170,170,0,0,0,0,0,170,0,170,170,0
"Atkinson township, Carlton County, Minnesota",404,397,7,2,2,0,4,404,9,395,396,8
"Automba township, Carlton County, Minnesota",122,122,0,0,0,0,0,122,0,122,122,0
"Barnum city, Carlton County, Minnesota",684,681,0,16,3,0,0,684,0,684,668,16
"Barnum township, Carlton County, Minnesota",810,810,0,6,0,0,0,810,0,810,804,6
"Beseman township, Carlton County, Minnesota",137,134,1,3,0,0,0,137,4,133,136,1
"Blackhoof township, Carlton County, Minnesota",1057,1015,4,9,38,0,0,1057,1,1056,1048,9
"Carlton city, Carlton County, Minnesota",1003,972,4,25,0,0,15,1003,15,988,990,13
"Clear Creek UT, Carlton County, Minnesota",111,104,10,0,0,0,0,111,0,111,108,3
"Cloquet city, Carlton County, Minnesota",11965,10408,280,1488,196,0,90,11965,290,11675,11470,495
"Cromwell city, Carlton County, Minnesota",287,285,0,2,0,0,0,287,0,287,287,0
"Eagle township, Carlton County, Minnesota",492,492,0,4,0,0,0,492,0,492,488,4
"Holyoke township, Carlton County, Minnesota",207,203,0,16,9,0,2,207,2,205,192,15
"Kalevala township, Carlton County, Minnesota",291,288,3,0,0,0,0,291,2,289,291,0
"Kettle River city, Carlton County, Minnesota",165,163,8,4,0,0,0,165,0,165,155,10
"Lakeview township, Carlton County, Minnesota",219,219,0,0,0,0,0,219,1,218,219,0
"Mahtowa township, Carlton County, Minnesota",660,645,7,3,12,0,7,660,12,648,648,12
"Moose Lake city, Carlton County, Minnesota",2815,2421,281,320,2,3,0,2815,98,2717,2603,212
"Moose Lake township, Carlton County, Minnesota",1152,1136,0,27,2,0,7,1152,16,1136,1132,20
"North Carlton UT, Carlton County, Minnesota",824,654,21,137,22,0,0,824,3,821,814,10
"Perch Lake township, Carlton County, Minnesota",991,737,11,306,1,2,3,991,16,975,922,69
"Scanlon city, Carlton County, Minnesota",1240,1182,35,29,0,0,4,1240,61,1179,1230,10
"Silver township, Carlton County, Minnesota",438,426,11,14,2,0,0,438,0,438,423,15
"Silver Brook township, Carlton County, Minnesota",678,666,3,20,0,0,0,678,2,676,667,11
"Skelton township, Carlton County, Minnesota",475,475,2,3,0,0,0,475,0,475,470,5
"Split Rock township, Carlton County, Minnesota",180,179,3,0,1,0,0,180,4,176,177,3
"Thomson township, Carlton County, Minnesota",5057,4992,57,48,0,5,0,5057,28,5029,5012,45
"Twin Lakes township, Carlton County, Minnesota",1951,1860,57,72,26,3,9,1951,28,1923,1889,62
"Wrenshall city, Carlton County, Minnesota",461,461,12,3,0,0,0,461,2,459,448,13
"Wrenshall township, Carlton County, Minnesota",381,366,0,15,2,0,0,381,2,379,379,2
"Wright city, Carlton County, Minnesota",151,133,21,0,3,0,0,151,5,146,146,5
"Benton township, Carver County, Minnesota",732,732,0,4,12,0,0,732,19,713,716,16
"Camden township, Carver County, Minnesota",888,879,0,1,13,0,0,888,4,884,883,5
"Carver city, Carver County, Minnesota",4470,4013,214,13,280,0,142,4470,138,4332,4278,192
"Chanhassen city, Carver County, Minnesota",25108,23107,393,81,1680,25,196,25108,900,24208,24759,349
"Chaska city, Carver County, Minnesota",25578,24092,802,314,1146,46,295,25578,2242,23336,24499,1079
"Cologne city, Carver County, Minnesota",1729,1581,119,15,12,0,31,1729,47,1682,1706,23
"Dahlgren township, Carver County, Minnesota",1267,1235,29,0,11,6,0,1267,2,1265,1253,14
"Hamburg city, Carver County, Minnesota",503,495,4,11,5,0,0,503,0,503,494,9
"Hancock township, Carver County, Minnesota",362,358,0,0,5,0,0,362,33,329,361,1
"Hollywood township, Carver County, Minnesota",965,958,2,5,11,0,0,965,39,926,954,11
"Laketown township, Carver County, Minnesota",2074,1928,29,16,96,5,20,2074,51,2023,2054,20
"Mayer city, Carver County, Minnesota",1977,1908,56,4,76,0,4,1977,17,1960,1906,71
"New Germany city, Carver County, Minnesota",399,398,5,3,1,0,0,399,0,399,391,8
"Norwood Young America city, Carver County, Minnesota",3686,3493,177,59,20,0,28,3686,44,3642,3595,91
"San Francisco township, Carver County, Minnesota",813,796,20,2,0,0,0,813,13,800,808,5
"Victoria city, Carver County, Minnesota",8679,8572,117,18,165,0,0,8679,111,8568,8495,184
"Waconia city, Carver County, Minnesota",11751,11535,243,18,87,0,44,11751,278,11473,11576,175
"Waconia township, Carver County, Minnesota",1153,1153,0,3,0,0,0,1153,0,1153,1150,3
"Watertown city, Carver County, Minnesota",4329,4263,38,70,34,0,0,4329,108,4221,4291,38
"Watertown township, Carver County, Minnesota",1593,1591,5,7,0,0,0,1593,0,1593,1588,5
"Young America township, Carver County, Minnesota",743,716,0,0,24,0,3,743,5,738,743,0
"Ansel township, Cass County, Minnesota",77,77,0,0,0,0,0,77,0,77,77,0
"Backus city, Cass County, Minnesota",313,313,8,0,0,0,0,313,6,307,305,8
"Barclay township, Cass County, Minnesota",619,615,0,4,6,0,0,619,0,619,613,6
"Becker township, Cass County, Minnesota",551,551,0,0,4,0,0,551,0,551,547,4
"Bena city, Cass County, Minnesota",106,41,25,91,0,0,0,106,0,106,77,29
"Beulah township, Cass County, Minnesota",80,80,0,0,0,0,0,80,0,80,80,0
"Birch Lake township, Cass County, Minnesota",511,485,0,9,13,0,4,511,6,505,511,0
"Blind Lake township, Cass County, Minnesota",83,83,0,0,0,0,0,83,0,83,83,0
"Boy Lake township, Cass County, Minnesota",267,130,0,142,0,0,0,267,0,267,262,5
"Boy River city, Cass County, Minnesota",59,59,0,0,0,0,0,59,0,59,59,0
"Boy River township, Cass County, Minnesota",62,60,0,2,0,0,0,62,0,62,62,0
"Bull Moose township, Cass County, Minnesota",144,144,0,0,0,0,0,144,0,144,144,0
"Bungo township, Cass County, Minnesota",148,146,2,0,0,0,0,148,0,148,148,0
"Byron township, Cass County, Minnesota",133,133,0,0,0,0,0,133,0,133,133,0
"Cass Lake city, Cass County, Minnesota",721,228,15,529,28,0,5,721,48,673,644,77
"Chickamaw Beach city, Cass County, Minnesota",123,123,0,0,0,0,0,123,3,120,123,0
"Crooked Lake township, Cass County, Minnesota",471,469,0,15,0,0,0,471,0,471,458,13
"Deerfield township, Cass County, Minnesota",127,124,0,0,3,0,0,127,3,124,127,0
"East Cass UT, Cass County, Minnesota",25,25,0,0,0,0,0,25,0,25,25,0
"East Gull Lake city, Cass County, Minnesota",975,975,0,4,0,0,0,975,18,957,971,4
"Fairview township, Cass County, Minnesota",889,887,0,2,2,0,0,889,17,872,887,2
"Federal Dam city, Cass County, Minnesota",91,74,1,21,6,0,0,91,0,91,84,7
"Gould township, Cass County, Minnesota",181,86,5,89,8,0,0,181,0,181,174,7
"Hackensack city, Cass County, Minnesota",276,270,2,13,0,0,0,276,0,276,267,9
"Hiram township, Cass County, Minnesota",327,326,1,0,1,0,1,327,2,325,325,2
"Home Brook township, Cass County, Minnesota",271,268,2,0,1,0,0,271,0,271,271,0
"Inguadona township, Cass County, Minnesota",206,199,3,10,2,0,11,206,14,192,187,19
"Kego township, Cass County, Minnesota",641,565,0,159,0,0,0,641,0,641,558,83
"Lake Shore city, Cass County, Minnesota",871,867,0,0,11,1,0,871,6,865,863,8
"Leech Lake township, Cass County, Minnesota",422,318,0,111,1,0,0,422,9,413,414,8
"Lima township, Cass County, Minnesota",120,114,0,12,0,0,0,120,0,120,114,6
"Longville city, Cass County, Minnesota",109,109,0,0,0,0,0,109,0,109,109,0
"Loon Lake township, Cass County, Minnesota",547,547,0,0,0,0,0,547,0,547,547,0
"McKinley township, Cass County, Minnesota",101,93,2,8,0,0,0,101,3,98,99,2
"Maple township, Cass County, Minnesota",347,345,2,0,0,0,0,347,7,340,347,0
"May township, Cass County, Minnesota",817,815,10,25,0,0,0,817,7,810,784,33
"Meadow Brook township, Cass County, Minnesota",258,252,0,25,6,0,0,258,16,242,233,25
"Moose Lake township, Cass County, Minnesota",127,124,0,3,0,0,0,127,0,127,127,0
"Motley city, Cass County, Minnesota",29,29,0,0,0,0,0,29,0,29,29,0
"North Cass UT, Cass County, Minnesota",174,69,14,105,0,0,0,174,28,146,160,14
"North Central Cass UT, Cass County, Minnesota",9,9,0,0,0,0,0,9,0,9,9,0
"Otter Tail Peninsula township, Cass County, Minnesota",53,52,0,1,0,0,0,53,0,53,53,0
"Pike Bay township, Cass County, Minnesota",1673,561,18,1262,23,0,2,1673,48,1625,1484,189
"Pillager city, Cass County, Minnesota",486,462,4,2,4,12,6,486,6,480,482,4
"Pine Lake township, Cass County, Minnesota",211,201,0,9,1,0,0,211,0,211,211,0
"Pine River city, Cass County, Minnesota",923,847,29,0,40,0,7,923,7,916,923,0
"Pine River township, Cass County, Minnesota",1209,1196,0,1,12,0,0,1209,14,1195,1209,0
"Ponto Lake township, Cass County, Minnesota",514,511,3,0,0,0,0,514,6,508,514,0
"Poplar township, Cass County, Minnesota",151,149,0,2,0,0,0,151,0,151,151,0
"Powers township, Cass County, Minnesota",603,590,8,3,3,0,0,603,0,603,602,1
"Remer city, Cass County, Minnesota",381,368,0,34,0,0,0,381,2,379,360,21
"Remer township, Cass County, Minnesota",194,179,15,0,0,0,0,194,0,194,194,0
"Rogers township, Cass County, Minnesota",88,71,0,16,1,0,0,88,0,88,88,0
"Salem township, Cass County, Minnesota",108,99,1,9,0,0,0,108,0,108,107,1
"Shingobee township, Cass County, Minnesota",1727,1449,50,348,3,0,0,1727,12,1715,1610,117
"Slater township, Cass County, Minnesota",233,222,0,7,6,0,0,233,5,228,231,2
"Smoky Hollow township, Cass County, Minnesota",72,72,0,0,0,0,0,72,0,72,72,0
"Sylvan township, Cass County, Minnesota",2723,2713,1,10,21,5,0,2723,226,2497,2696,27
"Thunder Lake township, Cass County, Minnesota",211,207,0,3,1,1,0,211,0,211,210,1
"Torrey township, Cass County, Minnesota",159,155,0,4,0,0,0,159,0,159,159,0
"Trelipe township, Cass County, Minnesota",132,130,0,2,0,0,0,132,13,119,132,0
"Turtle Lake township, Cass County, Minnesota",805,488,8,341,2,0,0,805,11,794,774,31
"Wabedo township, Cass County, Minnesota",409,409,0,0,0,0,0,409,0,409,409,0
"Wahnena UT, Cass County, Minnesota",117,115,0,2,0,0,0,117,0,117,117,0
"Walden township, Cass County, Minnesota",473,471,0,2,0,0,0,473,0,473,473,0
"Walker city, Cass County, Minnesota",933,750,29,176,5,0,4,933,2,931,902,31
"Wilkinson township, Cass County, Minnesota",509,249,14,284,3,0,0,509,24,485,475,34
"Wilson township, Cass County, Minnesota",612,568,1,54,11,11,0,612,0,612,601,11
"Woodrow township, Cass County, Minnesota",693,679,5,4,8,0,1,693,1,692,690,3
"Big Bend township, Chippewa County, Minnesota",279,279,0,0,4,0,0,279,4,275,275,4
"Clara City city, Chippewa County, Minnesota",1383,1343,0,0,0,0,40,1383,73,1310,1383,0
"Crate township, Chippewa County, Minnesota",186,186,0,0,0,0,0,186,0,186,186,0
"Grace township, Chippewa County, Minnesota",115,115,1,0,0,0,0,115,0,115,114,1
"Granite Falls township, Chippewa County, Minnesota",271,211,0,60,0,0,0,271,1,270,271,0
"Granite Falls city, Chippewa County, Minnesota",693,630,3,57,0,0,7,693,28,665,689,4
"Havelock township, Chippewa County, Minnesota",153,153,2,0,0,0,0,153,5,148,151,2
"Kragero township, Chippewa County, Minnesota",86,80,0,0,0,0,7,86,7,79,85,1
"Leenthrop township, Chippewa County, Minnesota",262,248,0,18,14,0,0,262,3,259,248,14
"Lone Tree township, Chippewa County, Minnesota",226,226,0,0,0,0,0,226,6,220,226,0
"Louriston township, Chippewa County, Minnesota",140,140,0,0,0,0,0,140,20,120,140,0
"Mandt township, Chippewa County, Minnesota",146,146,0,0,0,0,0,146,0,146,146,0
"Maynard city, Chippewa County, Minnesota",415,397,1,0,2,0,18,415,21,394,412,3
"Milan city, Chippewa County, Minnesota",344,185,0,0,7,124,30,344,44,300,342,2
"Montevideo city, Chippewa County, Minnesota",5165,4853,137,54,129,8,102,5165,479,4686,5047,118
"Raymond city, Chippewa County, Minnesota",0,0,0,0,0,0,0,0,0,0,0,0
"Rheiderland township, Chippewa County, Minnesota",251,247,0,0,0,0,4,251,21,230,251,0
"Rosewood township, Chippewa County, Minnesota",378,378,2,0,0,0,0,378,0,378,376,2
"Sparta township, Chippewa County, Minnesota",689,680,2,37,0,0,0,689,6,683,659,30
"Stoneham township, Chippewa County, Minnesota",253,251,0,0,0,0,4,253,19,234,251,2
"Tunsberg township, Chippewa County, Minnesota",222,221,0,0,2,0,0,222,0,222,221,1
"Watson city, Chippewa County, Minnesota",206,201,2,0,7,0,0,206,0,206,202,4
"Woods township, Chippewa County, Minnesota",177,131,27,0,0,0,21,177,22,155,176,1
"Amador township, Chisago County, Minnesota",786,766,5,4,10,0,5,786,10,776,782,4
"Center City city, Chisago County, Minnesota",684,673,2,2,6,0,2,684,18,666,683,1
"Chisago City city, Chisago County, Minnesota",5008,4928,22,73,62,0,47,5008,103,4905,4899,109
"Chisago Lake township, Chisago County, Minnesota",4735,4652,19,6,47,0,24,4735,102,4633,4722,13
"Fish Lake township, Chisago County, Minnesota",2010,1980,15,36,20,0,0,2010,0,2010,1979,31
"Franconia township, Chisago County, Minnesota",1773,1737,12,35,8,0,13,1773,41,1732,1741,32
"Harris city, Chisago County, Minnesota",1006,965,19,9,14,4,0,1006,14,992,1001,5
"Lent township, Chisago County, Minnesota",3050,2969,10,36,85,0,2,3050,24,3026,2998,52
"Lindstrom city, Chisago County, Minnesota",4442,4254,15,18,198,0,16,4442,100,4342,4393,49
"Nessel township, Chisago County, Minnesota",1837,1807,20,26,22,0,0,1837,29,1808,1799,38
"North Branch city, Chisago County, Minnesota",10241,10057,125,77,8,9,77,10241,374,9867,10129,112
"Rush City city, Chisago County, Minnesota",3106,2515,481,120,62,0,0,3106,66,3040,3049,57
"Rushseba township, Chisago County, Minnesota",739,682,14,18,53,0,0,739,10,729,711,28
"Shafer city, Chisago County, Minnesota",1139,1127,21,25,0,0,0,1139,5,1134,1106,33
"Shafer township, Chisago County, Minnesota",1001,987,29,11,3,0,0,1001,0,1001,972,29
"Stacy city, Chisago County, Minnesota",1723,1672,80,24,32,2,0,1723,11,1712,1636,87
"Sunrise township, Chisago County, Minnesota",2222,2132,76,2,16,0,0,2222,21,2201,2218,4
"Taylors Falls city, Chisago County, Minnesota",1002,987,0,28,0,0,0,1002,17,985,989,13
"Wyoming city, Chisago County, Minnesota",7793,7728,0,68,101,0,0,7793,147,7646,7689,104
"Alliance township, Clay County, Minnesota",267,267,0,0,0,0,0,267,0,267,267,0
"Barnesville city, Clay County, Minnesota",2574,2427,65,92,63,0,0,2574,15,2559,2501,73
"Barnesville township, Clay County, Minnesota",162,162,0,0,0,0,0,162,3,159,162,0
"Comstock city, Clay County, Minnesota",92,91,0,0,1,0,0,92,0,92,92,0
"Cromwell township, Clay County, Minnesota",438,435,0,0,3,0,0,438,0,438,438,0
"Dilworth city, Clay County, Minnesota",4293,4042,105,116,93,0,120,4293,305,3988,4110,183
"Eglon township, Clay County, Minnesota",538,530,3,0,5,0,0,538,0,538,538,0
"Elkton township, Clay County, Minnesota",359,348,0,8,0,0,3,359,3,356,359,0
"Elmwood township, Clay County, Minnesota",490,486,4,0,2,0,0,490,2,488,488,2
"Felton city, Clay County, Minnesota",147,147,0,0,0,0,0,147,0,147,147,0
"Felton township, Clay County, Minnesota",76,76,0,0,0,0,0,76,0,76,76,0
"Flowing township, Clay County, Minnesota",42,42,0,0,0,0,0,42,0,42,42,0
"Georgetown city, Clay County, Minnesota",74,74,0,0,0,0,0,74,12,62,74,0
"Georgetown township, Clay County, Minnesota",114,111,0,3,0,0,0,114,2,112,114,0
"Glyndon city, Clay County, Minnesota",1163,1103,20,46,0,0,15,1163,117,1046,1142,21
"Glyndon township, Clay County, Minnesota",311,311,0,0,0,0,0,311,5,306,311,0
"Goose Prairie township, Clay County, Minnesota",194,188,0,0,6,0,0,194,5,189,194,0
"Hagen township, Clay County, Minnesota",177,176,0,0,0,0,4,177,4,173,174,3
"Hawley city, Clay County, Minnesota",2009,1863,22,124,38,0,0,2009,58,1951,1971,38
"Hawley township, Clay County, Minnesota",460,459,0,7,0,0,0,460,3,457,454,6
"Highland Grove township, Clay County, Minnesota",301,297,0,0,4,0,0,301,0,301,301,0
"Hitterdal city, Clay County, Minnesota",176,176,0,0,0,0,0,176,18,158,176,0
"Holy Cross township, Clay County, Minnesota",165,163,0,0,2,0,0,165,0,165,165,0
"Humboldt township, Clay County, Minnesota",259,259,0,7,5,0,0,259,2,257,249,10
"Keene township, Clay County, Minnesota",140,140,0,7,0,0,0,140,7,133,133,7
"Kragnes township, Clay County, Minnesota",220,220,0,0,0,0,0,220,0,220,220,0
"Kurtz township, Clay County, Minnesota",224,220,0,24,0,4,0,224,1,223,200,24
"Moland township, Clay County, Minnesota",254,254,0,0,0,0,0,254,2,252,254,0
"Moorhead city, Clay County, Minnesota",41801,38926,1849,967,850,2,372,41801,2046,39755,40650,1151
"Moorhead township, Clay County, Minnesota",206,206,0,0,0,0,0,206,2,204,206,0
"Morken township, Clay County, Minnesota",128,128,0,0,0,0,0,128,0,128,128,0
"Oakport township, Clay County, Minnesota",859,804,0,40,101,15,15,859,15,844,743,116
"Parke township, Clay County, Minnesota",494,491,0,3,0,0,0,494,16,478,494,0
"Riverton township, Clay County, Minnesota",582,576,2,4,11,0,23,582,23,559,554,28
"Sabin city, Clay County, Minnesota",624,624,0,0,0,0,0,624,11,613,624,0
"Skree township, Clay County, Minnesota",157,145,3,0,8,2,2,157,9,148,154,3
"Spring Prairie township, Clay County, Minnesota",382,378,5,1,8,4,0,382,0,382,372,10
"Tansem township, Clay County, Minnesota",270,252,0,7,21,1,3,270,2,268,256,14
"Ulen city, Clay County, Minnesota",524,524,0,18,17,0,0,524,0,524,489,35
"Ulen township, Clay County, Minnesota",196,194,2,0,0,0,0,196,0,196,196,0
"Viding township, Clay County, Minnesota",98,77,0,17,4,0,0,98,0,98,98,0
"Bagley city, Clearwater County, Minnesota",1611,1465,32,162,10,0,0,1611,10,1601,1553,58
"Bear Creek township, Clearwater County, Minnesota",93,93,0,0,0,0,0,93,2,91,93,0
"Clearbrook city, Clearwater County, Minnesota",472,472,0,8,0,0,0,472,19,453,464,8
"Clover township, Clearwater County, Minnesota",57,57,0,0,0,0,0,57,0,57,57,0
"Copley township, Clearwater County, Minnesota",691,673,10,63,7,0,0,691,0,691,629,62
"Dudley township, Clearwater County, Minnesota",469,467,0,6,4,0,0,469,8,461,461,8
"Eddy township, Clearwater County, Minnesota",324,315,0,0,9,0,0,324,0,324,324,0
"Falk township, Clearwater County, Minnesota",324,250,4,101,0,10,5,324,1,323,280,44
"Gonvick city, Clearwater County, Minnesota",328,293,0,49,21,0,0,328,8,320,293,35
"Greenwood township, Clearwater County, Minnesota",68,60,0,7,3,0,0,68,0,68,66,2
"Hangaard township, Clearwater County, Minnesota",0,0,0,0,0,0,0,0,0,0,0,0
"Holst township, Clearwater County, Minnesota",354,352,0,9,0,0,11,354,11,343,336,18
"Itasca township, Clearwater County, Minnesota",114,104,0,10,0,0,0,114,3,111,114,0
"La Prairie township, Clearwater County, Minnesota",483,115,0,373,0,0,0,483,12,471,478,5
"Leon township, Clearwater County, Minnesota",362,362,0,3,3,0,0,362,8,354,359,3
"Leonard city, Clearwater County, Minnesota",38,38,0,0,0,0,0,38,0,38,38,0
"Long Lost Lake township, Clearwater County, Minnesota",82,66,0,16,0,0,0,82,0,82,82,0
"Minerva township, Clearwater County, Minnesota",209,199,0,21,0,2,0,209,16,193,196,13
"Moose Creek township, Clearwater County, Minnesota",269,269,0,6,0,0,0,269,0,269,263,6
"Nora township, Clearwater County, Minnesota",436,417,0,19,0,0,35,436,40,396,401,35
"North Clearwater UT, Clearwater County, Minnesota",67,13,0,54,0,0,0,67,13,54,67,0
"Pine Lake township, Clearwater County, Minnesota",443,425,0,34,4,0,0,443,3,440,423,20
"Popple township, Clearwater County, Minnesota",518,505,0,37,3,0,0,518,3,515,491,27
"Rice township, Clearwater County, Minnesota",106,79,0,29,0,0,0,106,3,103,104,2
"Shevlin city, Clearwater County, Minnesota",148,145,0,5,0,0,0,148,0,148,146,2
"Shevlin township, Clearwater County, Minnesota",492,482,0,6,2,0,2,492,13,479,492,0
"Sinclair township, Clearwater County, Minnesota",157,157,0,0,0,0,0,157,4,153,157,0
"South Clearwater UT, Clearwater County, Minnesota",0,0,0,0,0,0,0,0,0,0,0,0
"Winsor township, Clearwater County, Minnesota",109,92,0,17,0,0,0,109,0,109,109,0
"County subdivisions not defined, Cook County, Minnesota",0,0,0,0,0,0,0,0,0,0,0,0
"East Cook UT, Cook County, Minnesota",857,821,23,25,0,0,0,857,24,833,845,12
"Grand Marais city, Cook County, Minnesota",1191,1162,4,15,0,0,18,1191,34,1157,1183,8
"Grand Portage UT, Cook County, Minnesota",718,256,8,481,58,4,1,718,7,711,635,83
"Lutsen township, Cook County, Minnesota",560,537,0,0,2,2,23,560,23,537,558,2
"Schroeder township, Cook County, Minnesota",186,186,0,6,0,0,0,186,0,186,180,6
"Tofte township, Cook County, Minnesota",236,222,0,0,0,0,14,236,14,222,236,0
"West Cook UT, Cook County, Minnesota",1522,1522,0,14,0,0,0,1522,7,1515,1508,14
"Amboy township, Cottonwood County, Minnesota",148,148,4,0,0,0,0,148,0,148,144,4
"Amo township, Cottonwood County, Minnesota",82,82,0,0,0,0,0,82,0,82,82,0
"Ann township, Cottonwood County, Minnesota",144,144,0,0,0,0,0,144,0,144,144,0
"Bingham Lake city, Cottonwood County, Minnesota",175,164,8,0,4,0,0,175,0,175,174,1
"Carson township, Cottonwood County, Minnesota",313,313,0,4,0,0,0,313,0,313,309,4
"Comfrey city, Cottonwood County, Minnesota",30,30,0,0,0,0,0,30,0,30,30,0
"Dale township, Cottonwood County, Minnesota",97,97,0,0,0,0,0,97,0,97,97,0
"Delton township, Cottonwood County, Minnesota",137,137,0,0,0,0,0,137,5,132,137,0
"Germantown township, Cottonwood County, Minnesota",216,206,0,0,0,0,10,216,10,206,216,0
"Great Bend township, Cottonwood County, Minnesota",419,416,14,0,3,0,0,419,0,419,405,14
"Highwater township, Cottonwood County, Minnesota",134,134,0,0,0,0,0,134,0,134,134,0
"Jeffers city, Cottonwood County, Minnesota",387,385,0,2,0,0,0,387,34,353,387,0
"Lakeside township, Cottonwood County, Minnesota",281,276,0,0,5,0,0,281,0,281,281,0
"Midway township, Cottonwood County, Minnesota",185,179,0,0,6,0,0,185,0,185,185,0
"Mountain Lake city, Cottonwood County, Minnesota",2084,1688,44,49,224,0,153,2084,294,1790,2010,74
"Mountain Lake township, Cottonwood County, Minnesota",245,245,0,0,0,0,0,245,2,243,245,0
"Rose Hill township, Cottonwood County, Minnesota",140,140,0,0,0,0,0,140,0,140,140,0
"Selma township, Cottonwood County, Minnesota",147,147,0,0,0,0,0,147,0,147,147,0
"Southbrook township, Cottonwood County, Minnesota",69,69,0,0,0,0,0,69,0,69,69,0
"Springfield township, Cottonwood County, Minnesota",115,115,0,0,0,0,0,115,0,115,115,0
"Storden city, Cottonwood County, Minnesota",275,271,14,0,3,0,0,275,15,260,263,12
"Storden township, Cottonwood County, Minnesota",112,112,0,0,0,0,0,112,0,112,112,0
"Westbrook city, Cottonwood County, Minnesota",727,723,1,3,2,0,0,727,4,723,725,2
"Westbrook township, Cottonwood County, Minnesota",287,287,0,0,0,0,0,287,0,287,287,0
"Windom city, Cottonwood County, Minnesota",4488,3979,83,29,141,44,292,4488,450,4038,4408,80
"Baxter city, Crow Wing County, Minnesota",7988,7756,66,112,189,0,52,7988,79,7909,7801,187
"Bay Lake township, Crow Wing County, Minnesota",889,856,7,29,0,0,0,889,33,856,886,3
"Brainerd city, Crow Wing County, Minnesota",13394,12750,548,360,59,0,41,13394,267,13127,13052,342
"Breezy Point city, Crow Wing County, Minnesota",2239,2232,0,13,28,0,0,2239,43,2196,2205,34
"Center township, Crow Wing County, Minnesota",887,882,0,5,0,0,0,887,4,883,887,0
"Crosby city, Crow Wing County, Minnesota",2719,2647,0,95,81,0,0,2719,86,2633,2615,104
"Crosslake city, Crow Wing County, Minnesota",1865,1863,1,1,0,0,0,1865,1,1864,1865,0
"Crow Wing township, Crow Wing County, Minnesota",2113,2091,4,12,12,3,0,2113,23,2090,2104,9
"Cuyuna city, Crow Wing County, Minnesota",316,314,0,0,2,0,2,316,8,308,314,2
"Daggett Brook township, Crow Wing County, Minnesota",659,659,0,0,0,0,0,659,0,659,659,0
"Deerwood city, Crow Wing County, Minnesota",547,547,34,47,3,0,0,547,29,518,497,50
"Deerwood township, Crow Wing County, Minnesota",1225,1201,10,12,12,0,8,1225,8,1217,1207,18
"Emily city, Crow Wing County, Minnesota",613,604,0,0,5,0,4,613,4,609,613,0
"Fairfield township, Crow Wing County, Minnesota",316,316,1,0,0,0,0,316,0,316,315,1
"Fifty Lakes city, Crow Wing County, Minnesota",380,378,0,2,0,0,2,380,11,369,378,2
"First Assessment UT, Crow Wing County, Minnesota",5561,5398,16,198,0,0,0,5561,0,5561,5526,35
"Fort Ripley city, Crow Wing County, Minnesota",34,33,0,0,1,0,0,34,0,34,34,0
"Fort Ripley township, Crow Wing County, Minnesota",1037,1025,17,2,0,0,0,1037,21,1016,1030,7
"Gail Lake township, Crow Wing County, Minnesota",74,73,0,6,1,0,0,74,3,71,68,6
"Garrison city, Crow Wing County, Minnesota",205,192,0,5,0,0,8,205,12,193,205,0
"Garrison township, Crow Wing County, Minnesota",645,641,0,6,1,0,0,645,33,612,642,3
"Ideal township, Crow Wing County, Minnesota",1195,1193,7,5,1,1,0,1195,2,1193,1183,12
"Irondale township, Crow Wing County, Minnesota",1343,1323,14,41,0,0,0,1343,10,1333,1308,35
"Ironton city, Crow Wing County, Minnesota",608,571,0,17,20,0,0,608,15,593,608,0
"Jenkins city, Crow Wing County, Minnesota",408,399,0,0,9,0,0,408,3,405,408,0
"Jenkins township, Crow Wing County, Minnesota",330,328,2,0,9,0,0,330,0,330,321,9
"Lake Edward township, Crow Wing County, Minnesota",2013,1993,0,26,6,0,0,2013,27,1986,2001,12
"Little Pine township, Crow Wing County, Minnesota",56,56,0,0,0,0,0,56,0,56,56,0
"Long Lake township, Crow Wing County, Minnesota",1078,1069,0,8,1,0,0,1078,6,1072,1078,0
"Manhattan Beach city, Crow Wing County, Minnesota",83,83,0,0,0,0,0,83,0,83,83,0
"Maple Grove township, Crow Wing County, Minnesota",753,750,0,3,0,0,3,753,0,753,750,3
"Mission township, Crow Wing County, Minnesota",776,774,2,0,0,0,0,776,0,776,776,0
"Nisswa city, Crow Wing County, Minnesota",1962,1939,0,7,22,0,28,1962,28,1934,1928,34
"Nokay Lake township, Crow Wing County, Minnesota",920,894,7,23,0,0,0,920,16,904,916,4
"Oak Lawn township, Crow Wing County, Minnesota",1884,1863,20,19,18,0,0,1884,37,1847,1864,20
"Pelican township, Crow Wing County, Minnesota",452,446,10,3,0,0,0,452,0,452,445,7
"Pequot Lakes city, Crow Wing County, Minnesota",2499,2471,25,6,3,0,0,2499,33,2466,2493,6
"Perry Lake township, Crow Wing County, Minnesota",318,300,2,23,0,0,0,318,18,300,313,5
"Platte Lake township, Crow Wing County, Minnesota",540,540,0,1,0,0,0,540,14,526,539,1
"Rabbit Lake township, Crow Wing County, Minnesota",302,300,0,0,2,0,0,302,0,302,302,0
"Riverton city, Crow Wing County, Minnesota",160,160,2,0,1,0,0,160,0,160,157,3
"Roosevelt township, Crow Wing County, Minnesota",600,583,0,35,0,0,0,600,7,593,582,18
"Ross Lake township, Crow Wing County, Minnesota",189,189,0,0,0,2,0,189,0,189,187,2
"St. Mathias township, Crow Wing County, Minnesota",697,697,22,4,13,0,0,697,26,671,658,39
"Second Assessment UT, Crow Wing County, Minnesota",87,87,0,0,0,0,0,87,0,87,87,0
"Timothy township, Crow Wing County, Minnesota",174,174,0,0,0,0,0,174,0,174,174,0
"Trommald city, Crow Wing County, Minnesota",73,66,0,2,0,0,11,73,11,62,67,6
"Wolford township, Crow Wing County, Minnesota",299,296,3,4,0,0,0,299,0,299,295,4
"Apple Valley city, Dakota County, Minnesota",51109,42993,4487,327,3632,45,1244,51109,2606,48503,49556,1553
"Burnsville city, Dakota County, Minnesota",61302,47848,9101,563,3386,197,3496,61302,5580,55722,58491,2811
"Castle Rock township, Dakota County, Minnesota",1393,1390,15,17,0,0,4,1393,15,1378,1360,33
"Coates city, Dakota County, Minnesota",162,162,0,0,0,0,0,162,0,162,162,0
"Douglas township, Dakota County, Minnesota",792,790,7,31,8,5,4,792,24,768,750,42
"Eagan city, Dakota County, Minnesota",66102,54029,6288,835,6158,99,1177,66102,3134,62968,63792,2310
"Empire township, Dakota County, Minnesota",2811,2678,110,32,128,0,0,2811,117,2694,2700,111
"Eureka township, Dakota County, Minnesota",1440,1430,12,2,0,0,8,1440,19,1421,1428,12
"Farmington city, Dakota County, Minnesota",22502,21092,665,353,745,12,319,22502,702,21800,21836,666
"Greenvale township, Dakota County, Minnesota",764,762,9,1,0,0,0,764,0,764,756,8
"Hampton city, Dakota County, Minnesota",701,694,4,0,10,11,2,701,11,690,681,20
"Hampton township, Dakota County, Minnesota",913,913,0,2,0,0,0,913,15,898,911,2
"Hastings city, Dakota County, Minnesota",22620,21768,631,291,134,31,295,22620,751,21869,22118,502
"Inver Grove Heights city, Dakota County, Minnesota",34976,29497,2185,199,2020,27,1919,34976,3613,31363,34105,871
"Lakeville city, Dakota County, Minnesota",61056,55476,1790,195,3620,74,1286,61056,2628,58428,59714,1342
"Lilydale city, Dakota County, Minnesota",838,820,0,0,24,0,5,838,6,832,827,11
"Marshan township, Dakota County, Minnesota",1187,1162,7,40,5,0,8,1187,26,1161,1152,35
"Mendota city, Dakota County, Minnesota",296,285,8,5,17,0,1,296,33,263,276,20
"Mendota Heights city, Dakota County, Minnesota",11253,10667,160,95,318,39,172,11253,441,10812,11064,189
"Miesville city, Dakota County, Minnesota",152,152,0,0,0,0,0,152,15,137,152,0
"New Trier city, Dakota County, Minnesota",110,110,0,0,0,0,0,110,0,110,110,0
"Nininger township, Dakota County, Minnesota",819,817,4,1,5,0,0,819,3,816,811,8
"Northfield city, Dakota County, Minnesota",1151,1125,0,20,32,0,0,1151,0,1151,1125,26
"Randolph city, Dakota County, Minnesota",467,467,0,3,1,0,0,467,0,467,463,4
"Randolph township, Dakota County, Minnesota",674,674,0,3,2,0,0,674,2,672,669,5
"Ravenna township, Dakota County, Minnesota",2368,2278,38,18,67,0,0,2368,24,2344,2335,33
"Rosemount city, Dakota County, Minnesota",23474,20809,1528,139,1427,56,307,23474,926,22548,22703,771
"Sciota township, Dakota County, Minnesota",489,486,4,2,3,0,0,489,0,489,483,6
"South St. Paul city, Dakota County, Minnesota",20280,17719,1229,516,813,38,1203,20280,2964,17316,19091,1189
"Sunfish Lake city, Dakota County, Minnesota",520,498,4,0,16,0,4,520,7,513,518,2
"Vermillion city, Dakota County, Minnesota",483,471,2,0,12,0,0,483,0,483,481,2
"Vermillion township, Dakota County, Minnesota",1212,1162,0,2,48,0,0,1212,7,1205,1212,0
"Waterford township, Dakota County, Minnesota",489,468,38,1,7,0,0,489,6,483,464,25
"West St. Paul city, Dakota County, Minnesota",19750,15382,1876,409,1172,0,2216,19750,4345,15405,18684,1066
"Ashland township, Dodge County, Minnesota",347,347,0,0,0,0,0,347,0,347,347,0
"Blooming Prairie city, Dodge County, Minnesota",0,0,0,0,0,0,0,0,0,0,0,0
"Canisteo township, Dodge County, Minnesota",635,634,0,0,1,0,0,635,16,619,635,0
"Claremont city, Dodge County, Minnesota",632,576,12,9,0,0,35,632,147,485,632,0
"Claremont township, Dodge County, Minnesota",428,423,0,0,0,1,5,428,5,423,427,1
"Concord township, Dodge County, Minnesota",572,571,0,1,0,1,0,572,14,558,571,1
"Dodge Center city, Dodge County, Minnesota",2711,2607,55,43,43,0,66,2711,363,2348,2634,77
"Ellington township, Dodge County, Minnesota",253,251,3,17,0,0,0,253,6,247,235,18
"Hayfield city, Dodge County, Minnesota",1343,1301,30,11,6,0,27,1343,41,1302,1311,32
"Hayfield township, Dodge County, Minnesota",470,468,0,1,2,0,0,470,3,467,469,1
"Kasson city, Dodge County, Minnesota",6228,6111,105,15,119,0,0,6228,57,6171,6106,122
"Mantorville city, Dodge County, Minnesota",1082,1039,16,25,1,0,11,1082,18,1064,1072,10
"Mantorville township, Dodge County, Minnesota",1859,1847,0,16,14,9,9,1859,12,1847,1832,27
"Milton township, Dodge County, Minnesota",783,777,4,0,2,0,4,783,67,716,779,4
"Ripley township, Dodge County, Minnesota",187,169,0,0,0,0,18,187,43,144,187,0
"Vernon township, Dodge County, Minnesota",734,733,3,0,0,0,1,734,0,734,731,3
"Wasioja township, Dodge County, Minnesota",1006,966,6,9,16,2,20,1006,121,885,993,13
"West Concord city, Dodge County, Minnesota",765,743,10,3,0,0,18,765,85,680,756,9
"Westfield township, Dodge County, Minnesota",450,450,0,0,0,0,0,450,7,443,450,0
"Alexandria city, Douglas County, Minnesota",13203,12798,320,150,31,0,146,13203,276,12927,12961,242
"Alexandria township, Douglas County, Minnesota",2750,2723,21,22,0,0,0,2750,10,2740,2734,16
"Belle River township, Douglas County, Minnesota",364,364,0,1,0,0,0,364,0,364,363,1
"Brandon city, Douglas County, Minnesota",528,528,1,9,0,0,3,528,0,528,515,13
"Brandon township, Douglas County, Minnesota",698,694,0,0,11,0,0,698,3,695,691,7
"Carlos city, Douglas County, Minnesota",472,472,0,0,0,0,0,472,15,457,472,0
"Carlos township, Douglas County, Minnesota",1875,1838,12,16,9,0,0,1875,21,1854,1875,0
"Evansville city, Douglas County, Minnesota",617,607,0,22,0,0,7,617,0,617,598,19
"Evansville township, Douglas County, Minnesota",181,181,0,0,0,0,0,181,0,181,181,0
"Forada city, Douglas County, Minnesota",204,202,2,0,0,0,0,204,0,204,204,0
"Garfield city, Douglas County, Minnesota",270,258,14,2,0,0,0,270,2,268,266,4
"Holmes City township, Douglas County, Minnesota",810,805,0,0,0,0,5,810,4,806,810,0
"Hudson township, Douglas County, Minnesota",1068,1056,1,5,5,0,4,1068,65,1003,1065,3
"Ida township, Douglas County, Minnesota",1327,1327,0,4,0,0,0,1327,30,1297,1323,4
"Kensington city, Douglas County, Minnesota",246,243,0,0,6,0,0,246,0,246,243,3
"La Grand township, Douglas County, Minnesota",4223,4167,94,2,0,0,15,4223,24,4199,4168,55
"Lake Mary township, Douglas County, Minnesota",1303,1299,0,7,0,0,0,1303,0,1303,1300,3
"Leaf Valley township, Douglas County, Minnesota",373,366,3,0,0,0,4,373,6,367,373,0
"Lund township, Douglas County, Minnesota",378,376,0,2,0,0,0,378,5,373,378,0
"Millerville city, Douglas County, Minnesota",85,85,0,0,0,0,0,85,0,85,85,0
"Millerville township, Douglas County, Minnesota",372,355,0,0,3,0,14,372,0,372,372,0
"Miltona city, Douglas County, Minnesota",362,362,1,0,0,0,0,362,17,345,361,1
"Miltona township, Douglas County, Minnesota",857,857,0,0,0,0,0,857,0,857,857,0
"Moe township, Douglas County, Minnesota",747,740,0,0,15,0,0,747,27,720,739,8
"Nelson city, Douglas County, Minnesota",179,179,0,2,0,0,0,179,6,173,177,2
"Orange township, Douglas County, Minnesota",376,374,0,4,0,0,3,376,3,373,371,5
"Osakis city, Douglas County, Minnesota",1504,1490,12,11,12,2,6,1504,56,1448,1481,23
"Osakis township, Douglas County, Minnesota",576,576,7,0,0,0,0,576,0,576,569,7
"Solem township, Douglas County, Minnesota",267,265,0,2,0,0,0,267,0,267,267,0
"Spruce Hill township, Douglas County, Minnesota",465,461,0,0,8,0,0,465,0,465,461,4
"Urness township, Douglas County, Minnesota",211,209,0,0,2,0,0,211,0,211,211,0
"Barber township, Faribault County, Minnesota",247,247,0,1,0,0,0,247,0,247,246,1
"Blue Earth city, Faribault County, Minnesota",3169,3113,7,81,0,0,44,3169,230,2939,3093,76
"Blue Earth City township, Faribault County, Minnesota",380,380,0,0,0,0,0,380,0,380,380,0
"Bricelyn city, Faribault County, Minnesota",331,322,3,5,19,0,0,331,52,279,313,18
"Brush Creek township, Faribault County, Minnesota",181,181,0,6,0,0,0,181,3,178,175,6
"Clark township, Faribault County, Minnesota",288,288,0,0,0,0,0,288,0,288,288,0
"Delavan city, Faribault County, Minnesota",256,254,0,0,2,0,0,256,46,210,256,0
"Delavan township, Faribault County, Minnesota",195,195,0,0,0,0,0,195,0,195,195,0
"Dunbar township, Faribault County, Minnesota",268,268,0,0,0,0,0,268,0,268,268,0
"Easton city, Faribault County, Minnesota",192,191,0,0,0,0,4,192,3,189,189,3
"Elmore city, Faribault County, Minnesota",532,517,15,0,3,3,3,532,33,499,529,3
"Elmore township, Faribault County, Minnesota",199,196,2,0,0,0,3,199,11,188,197,2
"Emerald township, Faribault County, Minnesota",211,211,0,3,0,0,0,211,0,211,208,3
"Foster township, Faribault County, Minnesota",186,186,2,0,0,0,0,186,0,186,184,2
"Frost city, Faribault County, Minnesota",218,215,5,0,0,0,0,218,13,205,216,2
"Jo Daviess township, Faribault County, Minnesota",212,208,0,0,4,0,4,212,4,208,208,4
"Kiester city, Faribault County, Minnesota",426,426,5,0,0,0,0,426,12,414,421,5
"Kiester township, Faribault County, Minnesota",236,236,0,0,0,0,0,236,14,222,236,0
"Lura township, Faribault County, Minnesota",165,165,2,0,0,0,0,165,0,165,163,2
"Minnesota Lake city, Faribault County, Minnesota",586,586,0,0,0,0,0,586,10,576,586,0
"Minnesota Lake township, Faribault County, Minnesota",202,194,0,0,16,0,0,202,1,201,194,8
"Pilot Grove township, Faribault County, Minnesota",146,146,0,0,0,0,0,146,0,146,146,0
"Prescott township, Faribault County, Minnesota",165,164,0,0,0,0,1,165,1,164,165,0
"Rome township, Faribault County, Minnesota",126,126,0,0,0,0,0,126,0,126,126,0
"Seely township, Faribault County, Minnesota",165,165,0,0,0,0,0,165,0,165,165,0
"Verona township, Faribault County, Minnesota",431,430,1,0,0,0,0,431,10,421,431,0
"Walnut Lake township, Faribault County, Minnesota",191,191,0,0,0,0,0,191,2,189,191,0
"Walters city, Faribault County, Minnesota",123,122,0,0,0,0,1,123,1,122,123,0
"Wells city, Faribault County, Minnesota",2377,2319,62,0,32,0,42,2377,320,2057,2299,78
"Winnebago city, Faribault County, Minnesota",1401,1395,1,6,0,0,0,1401,132,1269,1400,1
"Winnebago City township, Faribault County, Minnesota",161,161,0,0,0,0,0,161,0,161,161,0
"Amherst township, Fillmore County, Minnesota",370,370,0,0,0,0,0,370,0,370,370,0
"Arendahl township, Fillmore County, Minnesota",315,311,2,0,7,0,2,315,0,315,308,7
"Beaver township, Fillmore County, Minnesota",192,192,0,0,0,0,0,192,0,192,192,0
"Bloomfield township, Fillmore County, Minnesota",268,263,2,0,1,0,2,268,2,266,268,0
"Bristol township, Fillmore County, Minnesota",502,493,0,11,18,0,0,502,0,502,482,20
"Canton city, Fillmore County, Minnesota",307,293,14,0,0,0,0,307,0,307,307,0
"Canton township, Fillmore County, Minnesota",522,522,0,0,0,0,0,522,37,485,522,0
"Carimona township, Fillmore County, Minnesota",311,303,0,0,8,0,0,311,0,311,311,0
"Carrolton township, Fillmore County, Minnesota",317,311,6,0,0,0,0,317,0,317,317,0
"Chatfield city, Fillmore County, Minnesota",1826,1799,36,0,0,0,0,1826,79,1747,1817,9
"Chatfield township, Fillmore County, Minnesota",495,495,0,0,0,0,0,495,8,487,495,0
"Fillmore township, Fillmore County, Minnesota",532,532,2,2,0,0,0,532,0,532,530,2
"Forestville township, Fillmore County, Minnesota",314,314,0,3,9,0,3,314,0,314,302,12
"Fountain city, Fillmore County, Minnesota",358,358,1,0,0,0,0,358,0,358,357,1
"Fountain township, Fillmore County, Minnesota",309,297,6,0,6,0,0,309,28,281,309,0
"Harmony city, Fillmore County, Minnesota",1001,996,9,0,0,0,0,1001,8,993,997,4
"Harmony township, Fillmore County, Minnesota",444,441,0,0,0,3,0,444,0,444,444,0
"Holt township, Fillmore County, Minnesota",276,276,0,0,0,0,0,276,0,276,276,0
"Jordan township, Fillmore County, Minnesota",303,303,0,2,0,0,0,303,0,303,301,2
"Lanesboro city, Fillmore County, Minnesota",701,693,4,14,0,0,0,701,14,687,691,10
"Mabel city, Fillmore County, Minnesota",810,803,5,0,7,0,0,810,18,792,805,5
"Newburg township, Fillmore County, Minnesota",433,430,0,0,3,0,0,433,0,433,433,0
"Norway township, Fillmore County, Minnesota",313,313,0,1,0,0,0,313,52,261,312,1
"Ostrander city, Fillmore County, Minnesota",233,232,0,4,0,2,0,233,7,226,228,5
"Peterson city, Fillmore County, Minnesota",187,187,0,0,0,0,0,187,0,187,187,0
"Pilot Mound township, Fillmore County, Minnesota",301,299,0,0,2,0,0,301,0,301,301,0
"Preble township, Fillmore County, Minnesota",172,172,0,0,0,0,0,172,0,172,172,0
"Preston city, Fillmore County, Minnesota",1493,1479,4,8,6,0,0,1493,0,1493,1489,4
"Preston township, Fillmore County, Minnesota",351,351,0,0,0,0,0,351,0,351,351,0
"Rushford city, Fillmore County, Minnesota",1813,1785,18,0,0,0,10,1813,28,1785,1813,0
"Rushford Village city, Fillmore County, Minnesota",903,900,6,6,9,0,0,903,3,900,885,18
"Spring Valley city, Fillmore County, Minnesota",2429,2365,0,28,67,0,5,2429,5,2424,2393,36
"Spring Valley township, Fillmore County, Minnesota",587,582,2,3,3,0,0,587,5,582,584,3
"Sumner township, Fillmore County, Minnesota",374,373,0,1,0,0,0,374,0,374,374,0
"Whalan city, Fillmore County, Minnesota",57,48,7,2,0,2,0,57,4,53,55,2
"Wykoff city, Fillmore County, Minnesota",394,390,10,0,0,0,0,394,0,394,388,6
"York township, Fillmore County, Minnesota",312,304,8,0,0,0,0,312,0,312,312,0
"Albert Lea city, Freeborn County, Minnesota",17716,16581,446,193,521,14,255,17716,2383,15333,17427,289
"Albert Lea township, Freeborn County, Minnesota",614,606,7,8,1,0,0,614,90,524,606,8
"Alden city, Freeborn County, Minnesota",685,682,0,2,2,2,7,685,57,628,675,10
"Alden township, Freeborn County, Minnesota",287,287,0,0,0,0,0,287,0,287,287,0
"Bancroft township, Freeborn County, Minnesota",1017,1001,8,4,11,0,5,1017,71,946,1005,12
"Bath township, Freeborn County, Minnesota",434,433,0,0,1,0,0,434,4,430,434,0
"Carlston township, Freeborn County, Minnesota",216,215,0,0,1,0,0,216,0,216,216,0
"Clarks Grove city, Freeborn County, Minnesota",680,588,3,0,90,0,0,680,28,652,679,1
"Conger city, Freeborn County, Minnesota",154,154,0,5,0,0,0,154,0,154,149,5
"Emmons city, Freeborn County, Minnesota",405,405,0,0,0,0,0,405,28,377,405,0
"Freeborn city, Freeborn County, Minnesota",314,314,0,1,0,0,0,314,12,302,313,1
"Freeborn township, Freeborn County, Minnesota",197,197,0,0,2,0,0,197,0,197,195,2
"Freeman township, Freeborn County, Minnesota",497,489,6,0,6,0,0,497,17,480,493,4
"Geneva city, Freeborn County, Minnesota",328,328,0,0,0,0,0,328,0,328,328,0
"Geneva township, Freeborn County, Minnesota",423,423,0,0,0,0,0,423,1,422,423,0
"Glenville city, Freeborn County, Minnesota",571,571,0,0,4,0,2,571,25,546,565,6
"Hartland city, Freeborn County, Minnesota",311,301,4,0,6,0,0,311,1,310,311,0
"Hartland township, Freeborn County, Minnesota",152,152,0,0,0,0,0,152,0,152,152,0
"Hayward city, Freeborn County, Minnesota",270,260,0,0,2,0,8,270,13,257,270,0
"Hayward township, Freeborn County, Minnesota",373,368,3,2,0,0,0,373,0,373,373,0
"Hollandale city, Freeborn County, Minnesota",373,371,0,2,0,0,0,373,26,347,373,0
"London township, Freeborn County, Minnesota",245,245,0,0,0,0,0,245,0,245,245,0
"Manchester city, Freeborn County, Minnesota",49,49,0,0,0,0,0,49,0,49,49,0
"Manchester township, Freeborn County, Minnesota",444,424,6,9,9,9,8,444,8,436,423,21
"Mansfield township, Freeborn County, Minnesota",178,177,0,0,1,0,0,178,1,177,178,0
"Moscow township, Freeborn County, Minnesota",572,536,4,0,6,3,26,572,36,536,569,3
"Myrtle city, Freeborn County, Minnesota",54,54,0,0,0,0,0,54,0,54,54,0
"Newry township, Freeborn County, Minnesota",615,602,0,21,0,0,0,615,38,577,607,8
"Nunda township, Freeborn County, Minnesota",299,276,4,11,19,0,1,299,6,293,287,12
"Oakland township, Freeborn County, Minnesota",421,421,0,0,0,0,0,421,13,408,421,0
"Pickerel Lake township, Freeborn County, Minnesota",655,655,0,0,0,0,0,655,12,643,655,0
"Riceland township, Freeborn County, Minnesota",523,494,0,0,0,0,29,523,34,489,523,0
"Shell Rock township, Freeborn County, Minnesota",379,379,0,0,0,0,0,379,4,375,379,0
"Twin Lakes city, Freeborn County, Minnesota",168,168,0,0,0,0,0,168,0,168,168,0
"Bellechester city, Goodhue County, Minnesota",176,170,0,7,0,0,0,176,4,172,175,1
"Belle Creek township, Goodhue County, Minnesota",502,501,0,0,1,0,0,502,8,494,502,0
"Belvidere township, Goodhue County, Minnesota",445,445,0,2,0,0,0,445,1,444,443,2
"Cannon Falls city, Goodhue County, Minnesota",4049,4049,55,51,37,0,0,4049,58,3991,3906,143
"Cannon Falls township, Goodhue County, Minnesota",915,886,13,8,23,2,0,915,4,911,900,15
"Cherry Grove township, Goodhue County, Minnesota",410,407,0,0,3,0,0,410,0,410,410,0
"Dennison city, Goodhue County, Minnesota",170,170,0,0,0,0,4,170,4,166,166,4
"Featherstone township, Goodhue County, Minnesota",686,686,2,0,0,0,0,686,0,686,684,2
"Florence township, Goodhue County, Minnesota",1475,1468,2,26,7,0,0,1475,4,1471,1447,28
"Goodhue city, Goodhue County, Minnesota",1206,1175,7,3,9,9,18,1206,123,1083,1195,11
"Goodhue township, Goodhue County, Minnesota",505,505,3,0,3,1,0,505,8,497,498,7
"Hay Creek township, Goodhue County, Minnesota",770,755,4,16,6,1,0,770,2,768,758,12
"Holden township, Goodhue County, Minnesota",456,452,0,0,4,0,0,456,0,456,456,0
"Kenyon city, Goodhue County, Minnesota",1928,1844,30,15,33,0,31,1928,182,1746,1903,25
"Kenyon township, Goodhue County, Minnesota",405,405,0,0,0,0,1,405,1,404,404,1
"Lake City city, Goodhue County, Minnesota",861,857,1,2,1,0,0,861,0,861,861,0
"Leon township, Goodhue County, Minnesota",948,939,5,15,13,0,3,948,3,945,926,22
"Minneola township, Goodhue County, Minnesota",608,604,7,4,4,0,1,608,3,605,596,12
"Pine Island city, Goodhue County, Minnesota",2581,2500,56,0,34,0,0,2581,0,2581,2572,9
"Pine Island township, Goodhue County, Minnesota",659,648,7,2,4,0,0,659,0,659,657,2
"Red Wing city, Goodhue County, Minnesota",16334,15175,529,714,206,79,374,16334,872,15462,15652,682
"Roscoe township, Goodhue County, Minnesota",753,740,7,7,1,0,3,753,2,751,748,5
"Stanton township, Goodhue County, Minnesota",896,891,3,3,12,0,0,896,6,890,883,13
"Vasa township, Goodhue County, Minnesota",1062,1048,9,15,3,0,0,1062,3,1059,1049,13
"Wacouta township, Goodhue County, Minnesota",362,352,1,11,1,0,0,362,2,360,359,3
"Wanamingo city, Goodhue County, Minnesota",1182,1117,50,3,23,0,4,1182,61,1121,1167,15
"Wanamingo township, Goodhue County, Minnesota",337,333,2,1,4,0,2,337,4,333,334,3
"Warsaw township, Goodhue County, Minnesota",703,702,2,9,3,0,10,703,39,664,681,22
"Welch township, Goodhue County, Minnesota",691,628,3,54,13,0,0,691,3,688,684,7
"Zumbrota city, Goodhue County, Minnesota",3362,3328,18,9,8,0,29,3362,75,3287,3332,30
"Zumbrota township, Goodhue County, Minnesota",701,687,0,12,2,0,0,701,7,694,701,0
"Ashby city, Grant County, Minnesota",517,514,6,4,1,0,0,517,11,506,513,4
"Barrett city, Grant County, Minnesota",385,375,0,10,0,0,0,385,27,358,385,0
"Delaware township, Grant County, Minnesota",56,56,0,0,0,0,0,56,4,52,56,0
"Elbow Lake city, Grant County, Minnesota",1283,1274,29,37,23,0,2,1283,0,1283,1201,82
"Elbow Lake township, Grant County, Minnesota",132,132,0,0,0,0,0,132,0,132,132,0
"Elk Lake township, Grant County, Minnesota",309,305,0,0,4,0,0,309,17,292,309,0
"Erdahl township, Grant County, Minnesota",370,370,0,0,2,0,0,370,0,370,368,2
"Gorton township, Grant County, Minnesota",38,38,0,0,0,0,0,38,0,38,38,0
"Herman city, Grant County, Minnesota",404,399,5,0,0,0,2,404,0,404,402,2
"Hoffman city, Grant County, Minnesota",620,620,5,0,0,0,0,620,0,620,615,5
"Land township, Grant County, Minnesota",366,366,0,0,0,0,0,366,16,350,366,0
"Lawrence township, Grant County, Minnesota",78,78,0,0,0,0,0,78,0,78,78,0
"Lien township, Grant County, Minnesota",101,101,0,0,0,0,7,101,7,94,94,7
"Logan township, Grant County, Minnesota",83,77,0,0,0,0,6,83,6,77,83,0
"Macsville township, Grant County, Minnesota",121,121,0,0,0,0,0,121,0,121,121,0
"Norcross city, Grant County, Minnesota",37,37,0,0,0,0,0,37,0,37,37,0
"North Ottawa township, Grant County, Minnesota",37,37,0,0,0,0,0,37,0,37,37,0
"Pelican Lake township, Grant County, Minnesota",440,440,12,0,0,0,0,440,0,440,428,12
"Pomme de Terre township, Grant County, Minnesota",101,101,0,0,0,0,0,101,3,98,101,0
"Roseville township, Grant County, Minnesota",115,115,0,0,0,0,0,115,0,115,115,0
"Sanford township, Grant County, Minnesota",131,131,0,0,0,0,0,131,0,131,131,0
"Stony Brook township, Grant County, Minnesota",87,87,0,0,0,0,0,87,15,72,87,0
"Wendell city, Grant County, Minnesota",112,112,0,0,0,0,0,112,19,93,112,0
"Bloomington city, Hennepin County, Minnesota",85417,69074,9541,1061,5635,89,3828,85417,7484,77933,81858,3559
"Brooklyn Center city, Hennepin County, Minnesota",30885,15392,9347,366,5391,6,1586,30885,3348,27537,29748,1137
"Brooklyn Park city, Hennepin County, Minnesota",79462,41045,23812,732,14778,350,1690,79462,4942,74520,76692,2770
"Champlin city, Hennepin County, Minnesota",24209,21391,2368,290,791,0,166,24209,567,23642,23502,707
"Chanhassen city, Hennepin County, Minnesota",0,0,0,0,0,0,0,0,0,0,0,0
"Corcoran city, Hennepin County, Minnesota",5671,5351,40,7,297,0,21,5671,319,5352,5626,45
"Crystal city, Hennepin County, Minnesota",22910,18598,3337,259,833,0,413,22910,1901,21009,22402,508
"Dayton city, Hennepin County, Minnesota",5238,4852,111,44,55,0,251,5238,713,4525,5184,54
"Deephaven city, Hennepin County, Minnesota",3818,3666,51,7,68,0,74,3818,83,3735,3770,48
"Eden Prairie city, Hennepin County, Minnesota",63660,52279,4209,645,7141,143,926,63660,2815,60845,61998,1662
"Edina city, Hennepin County, Minnesota",50603,44642,1251,315,4845,119,807,50603,1509,49094,49358,1245
"Excelsior city, Hennepin County, Minnesota",2375,2280,40,25,55,0,32,2375,218,2157,2330,45
"Fort Snelling UT, Hennepin County, Minnesota",329,282,57,4,0,0,4,329,156,173,311,18
"Golden Valley city, Hennepin County, Minnesota",21208,18524,1877,247,1256,26,135,21208,614,20594,20435,773
"Greenfield city, Hennepin County, Minnesota",2913,2870,4,0,72,11,12,2913,6,2907,2864,49
"Greenwood city, Hennepin County, Minnesota",747,730,0,4,24,0,0,747,14,733,736,11
"Hanover city, Hennepin County, Minnesota",652,618,7,2,22,0,25,652,31,621,630,22
"Hopkins city, Hennepin County, Minnesota",18217,11346,3865,242,2008,56,1206,18217,2070,16147,17711,506
"Independence city, Hennepin County, Minnesota",3726,3659,23,4,0,8,36,3726,144,3582,3722,4
"Long Lake city, Hennepin County, Minnesota",1727,1706,18,0,15,0,0,1727,13,1714,1715,12
"Loretto city, Hennepin County, Minnesota",694,694,0,0,0,0,0,694,14,680,694,0
"Maple Grove city, Hennepin County, Minnesota",68362,59615,3576,608,5847,14,540,68362,1251,67111,66762,1600
"Maple Plain city, Hennepin County, Minnesota",1894,1683,188,45,27,33,45,1894,145,1749,1801,93
"Medicine Lake city, Hennepin County, Minnesota",373,356,9,0,8,6,3,373,2,371,364,9
"Medina city, Hennepin County, Minnesota",5920,5314,106,16,581,177,0,5920,194,5726,5646,274
"Minneapolis city, Hennepin County, Minnesota",411452,280540,88466,11067,30475,910,22091,411452,40147,371305,391234,20218
"Minnetonka city, Hennepin County, Minnesota",52102,46881,2978,241,2894,68,399,52102,1182,50920,50762,1340
"Minnetonka Beach city, Hennepin County, Minnesota",640,628,0,0,23,0,0,640,9,631,629,11
"Minnetrista city, Hennepin County, Minnesota",7187,6902,124,99,183,0,19,7187,19,7168,7047,140
"Mound city, Hennepin County, Minnesota",9380,9080,53,155,293,11,34,9380,76,9304,9176,204
"New Hope city, Hennepin County, Minnesota",20909,15262,4977,296,812,63,503,20909,1367,19542,19992,917
"Orono city, Hennepin County, Minnesota",7887,7643,30,50,148,0,86,7887,126,7761,7817,70
"Osseo city, Hennepin County, Minnesota",2680,2480,140,39,54,23,0,2680,25,2655,2624,56
"Plymouth city, Hennepin County, Minnesota",76258,63672,5045,911,8093,12,558,76258,3376,72882,74264,1994
"Richfield city, Hennepin County, Minnesota",35993,27058,4700,719,2897,57,2290,35993,5677,30316,34374,1619
"Robbinsdale city, Hennepin County, Minnesota",14446,11906,2172,249,721,0,483,14446,947,13499,13673,773
"Rockford city, Hennepin County, Minnesota",306,306,0,0,0,0,0,306,0,306,306,0
"Rogers city, Hennepin County, Minnesota",12564,11807,29,0,878,9,61,12564,75,12489,12344,220
"St. Anthony city, Hennepin County, Minnesota",5560,5092,122,260,338,0,0,5560,205,5355,5308,252
"St. Bonifacius city, Hennepin County, Minnesota",2471,2289,30,11,184,0,0,2471,67,2404,2435,36
"St. Louis Park city, Hennepin County, Minnesota",48124,41381,4443,360,2380,75,1125,48124,1840,46284,46525,1599
"Shorewood city, Hennepin County, Minnesota",7696,7576,12,35,175,35,32,7696,297,7399,7550,146
"Spring Park city, Hennepin County, Minnesota",1774,1711,42,0,38,5,0,1774,5,1769,1752,22
"Tonka Bay city, Hennepin County, Minnesota",1380,1331,17,0,15,11,9,1380,34,1346,1377,3
"Wayzata city, Hennepin County, Minnesota",4467,4134,315,0,93,0,0,4467,17,4450,4392,75
"Woodland city, Hennepin County, Minnesota",477,456,15,4,0,0,2,477,15,462,477,0
"Black Hammer township, Houston County, Minnesota",209,209,0,0,0,0,0,209,0,209,209,0
"Brownsville city, Houston County, Minnesota",639,622,3,14,0,0,3,639,3,636,636,3
"Brownsville township, Houston County, Minnesota",431,431,0,0,0,0,0,431,0,431,431,0
"Caledonia city, Houston County, Minnesota",2777,2686,78,35,14,0,3,2777,18,2759,2738,39
"Caledonia township, Houston County, Minnesota",558,555,3,0,0,0,0,558,3,555,558,0
"Crooked Creek township, Houston County, Minnesota",271,253,0,0,18,0,0,271,0,271,271,0
"Eitzen city, Houston County, Minnesota",231,231,0,0,0,0,0,231,10,221,231,0
"Hokah city, Houston County, Minnesota",597,580,43,14,0,26,1,597,7,590,530,67
"Hokah township, Houston County, Minnesota",450,450,0,0,0,0,0,450,2,448,450,0
"Houston city, Houston County, Minnesota",1045,1026,8,22,21,0,0,1045,4,1041,1013,32
"Houston township, Houston County, Minnesota",394,389,5,5,0,0,0,394,2,392,389,5
"Jefferson township, Houston County, Minnesota",107,107,0,0,0,0,0,107,0,107,107,0
"La Crescent city, Houston County, Minnesota",5046,4930,56,0,90,13,13,5046,104,4942,4990,56
"La Crescent township, Houston County, Minnesota",1116,1093,9,0,4,2,8,1116,6,1110,1116,0
"Mayville township, Houston County, Minnesota",390,390,0,0,0,0,0,390,9,381,390,0
"Money Creek township, Houston County, Minnesota",619,619,0,2,0,0,0,619,0,619,617,2
"Mound Prairie township, Houston County, Minnesota",642,639,4,3,4,4,0,642,0,642,638,4
"Sheldon township, Houston County, Minnesota",271,269,1,1,0,0,1,271,2,269,270,1
"Spring Grove city, Houston County, Minnesota",1314,1300,14,4,0,0,0,1314,3,1311,1310,4
"Spring Grove township, Houston County, Minnesota",368,363,0,0,0,0,5,368,4,364,368,0
"Union township, Houston County, Minnesota",314,314,0,0,0,0,0,314,0,314,314,0
"Wilmington township, Houston County, Minnesota",357,357,7,7,0,0,0,357,6,351,350,7
"Winnebago township, Houston County, Minnesota",279,279,0,0,0,0,0,279,0,279,279,0
"Yucatan township, Houston County, Minnesota",284,284,0,16,0,0,0,284,0,284,268,16
"Akeley city, Hubbard County, Minnesota",338,325,2,21,2,0,0,338,5,333,328,10
"Akeley township, Hubbard County, Minnesota",491,485,5,2,0,0,6,491,27,464,484,7
"Arago township, Hubbard County, Minnesota",662,659,3,0,0,0,0,662,0,662,662,0
"Badoura township, Hubbard County, Minnesota",107,102,3,3,2,0,0,107,3,104,104,3
"Clay township, Hubbard County, Minnesota",89,89,0,0,0,0,0,89,0,89,89,0
"Clover township, Hubbard County, Minnesota",164,164,0,0,0,0,0,164,5,159,164,0
"Crow Wing Lake township, Hubbard County, Minnesota",334,334,0,0,0,0,0,334,0,334,334,0
"Farden township, Hubbard County, Minnesota",965,851,29,106,28,12,0,965,52,913,919,46
"Fern township, Hubbard County, Minnesota",204,201,0,14,1,0,0,204,0,204,192,12
"Guthrie township, Hubbard County, Minnesota",493,488,0,8,3,0,4,493,11,482,483,10
"Hart Lake township, Hubbard County, Minnesota",559,448,0,118,1,0,2,559,9,550,549,10
"Helga township, Hubbard County, Minnesota",1725,1617,23,27,86,0,0,1725,17,1708,1699,26
"Hendrickson township, Hubbard County, Minnesota",292,286,4,4,4,0,0,292,0,292,286,6
"Henrietta township, Hubbard County, Minnesota",1558,1538,3,25,0,0,0,1558,12,1546,1550,8
"Hubbard township, Hubbard County, Minnesota",888,888,0,8,0,0,0,888,3,885,880,8
"Lake Alice township, Hubbard County, Minnesota",56,56,0,0,0,0,0,56,0,56,56,0
"Lake Emma township, Hubbard County, Minnesota",1066,1060,7,4,3,0,6,1066,11,1055,1052,14
"Lake George township, Hubbard County, Minnesota",337,336,2,14,0,0,0,337,17,320,322,15
"Lake Hattie township, Hubbard County, Minnesota",154,148,2,8,0,0,0,154,0,154,150,4
"Lakeport township, Hubbard County, Minnesota",964,902,0,80,7,0,0,964,19,945,939,25
"Laporte city, Hubbard County, Minnesota",181,181,0,0,0,0,0,181,0,181,181,0
"Mantrap township, Hubbard County, Minnesota",515,508,0,0,0,0,7,515,7,508,515,0
"Nevis city, Hubbard County, Minnesota",422,421,0,47,0,0,1,422,50,372,375,47
"Nevis township, Hubbard County, Minnesota",1013,1009,0,4,0,0,0,1013,0,1013,1013,0
"Park Rapids city, Hubbard County, Minnesota",3934,3636,172,202,20,0,20,3934,93,3841,3818,116
"Rockwood township, Hubbard County, Minnesota",421,413,1,19,0,0,0,421,0,421,409,12
"Schoolcraft township, Hubbard County, Minnesota",79,75,0,3,1,0,0,79,0,79,79,0
"Steamboat River township, Hubbard County, Minnesota",109,109,0,3,0,0,0,109,0,109,106,3
"Straight River township, Hubbard County, Minnesota",784,759,17,11,0,0,13,784,20,764,768,16
"Thorpe township, Hubbard County, Minnesota",30,30,0,0,0,0,0,30,0,30,30,0
"Todd township, Hubbard County, Minnesota",1274,1249,0,2,0,0,32,1274,52,1222,1265,9
"White Oak township, Hubbard County, Minnesota",535,533,0,2,0,0,0,535,0,535,535,0
"Athens township, Isanti County, Minnesota",1996,1945,17,14,59,0,10,1996,9,1987,1954,42
"Bradford township, Isanti County, Minnesota",3412,3319,21,43,9,0,65,3412,10,3402,3367,45
"Braham city, Isanti County, Minnesota",1866,1813,76,20,10,0,0,1866,68,1798,1813,53
"Cambridge city, Isanti County, Minnesota",8462,8107,214,146,339,0,36,8462,130,8332,8127,335
"Cambridge township, Isanti County, Minnesota",2283,2261,9,9,13,0,10,2283,0,2283,2264,19
"Dalbo township, Isanti County, Minnesota",848,846,8,0,0,0,0,848,3,845,842,6
"Isanti city, Isanti County, Minnesota",5458,5434,44,94,0,0,12,5458,177,5281,5332,126
"Isanti township, Isanti County, Minnesota",2500,2444,0,34,24,9,0,2500,0,2500,2489,11
"Maple Ridge township, Isanti County, Minnesota",743,727,5,11,3,0,11,743,67,676,729,14
"North Branch township, Isanti County, Minnesota",1728,1645,21,15,56,0,14,1728,68,1660,1705,23
"Oxford township, Isanti County, Minnesota",935,912,8,57,4,0,0,935,21,914,889,46
"St. Francis city, Isanti County, Minnesota",0,0,0,0,0,0,0,0,0,0,0,0
"Spencer Brook township, Isanti County, Minnesota",1596,1574,12,4,5,0,9,1596,22,1574,1588,8
"Springvale township, Isanti County, Minnesota",1666,1607,28,8,36,0,9,1666,56,1610,1644,22
"Stanchfield township, Isanti County, Minnesota",1013,990,12,0,0,0,11,1013,15,998,1013,0
"Stanford township, Isanti County, Minnesota",2343,2304,34,29,0,0,3,2343,53,2290,2316,27
"Wyanett township, Isanti County, Minnesota",1735,1709,0,17,10,0,1,1735,11,1724,1733,2
"Alvwood township, Itasca County, Minnesota",39,39,0,0,0,0,0,39,0,39,39,0
"Arbo township, Itasca County, Minnesota",859,820,8,18,3,0,22,859,30,829,847,12
"Ardenhurst township, Itasca County, Minnesota",162,155,3,0,0,0,4,162,4,158,162,0
"Balsam township, Itasca County, Minnesota",533,528,3,15,0,0,0,533,11,522,520,13
"Bearville township, Itasca County, Minnesota",183,177,0,6,0,0,0,183,0,183,183,0
"Bigfork city, Itasca County, Minnesota",401,396,2,20,0,0,0,401,3,398,384,17
"Bigfork township, Itasca County, Minnesota",286,273,9,7,3,0,4,286,18,268,276,10
"Blackberry township, Itasca County, Minnesota",872,860,0,7,3,0,4,872,23,849,870,2
"Bovey city, Itasca County, Minnesota",822,751,20,115,4,0,0,822,119,703,754,68
"Bowstring township, Itasca County, Minnesota",210,206,0,8,1,0,0,210,0,210,205,5
"Bowstring Lake UT, Itasca County, Minnesota",1035,508,10,549,0,0,19,1035,38,997,984,51
"Carpenter township, Itasca County, Minnesota",231,196,23,25,0,0,0,231,0,231,218,13
"Cohasset city, Itasca County, Minnesota",2731,2673,22,128,5,0,0,2731,0,2731,2634,97
"Coleraine city, Itasca County, Minnesota",1713,1695,6,57,9,0,0,1713,0,1713,1659,54
"Deer Lake UT, Itasca County, Minnesota",3511,3357,7,144,1,1,48,3511,53,3458,3464,47
"Deer River city, Itasca County, Minnesota",932,629,5,304,11,0,0,932,5,927,915,17
"Deer River township, Itasca County, Minnesota",601,577,0,30,0,0,0,601,29,572,595,6
"Effie city, Itasca County, Minnesota",69,67,0,0,2,0,0,69,0,69,69,0
"Effie UT, Itasca County, Minnesota",233,233,0,17,0,0,0,233,0,233,216,17
"Feeley township, Itasca County, Minnesota",327,323,0,10,0,0,0,327,2,325,321,6
"Good Hope township, Itasca County, Minnesota",105,105,0,0,0,0,0,105,0,105,105,0
"Goodland township, Itasca County, Minnesota",515,497,0,26,3,0,0,515,0,515,504,11
"Grand Rapids city, Itasca County, Minnesota",11099,10815,84,219,102,13,13,11099,57,11042,10952,147
"Grattan township, Itasca County, Minnesota",65,65,0,0,0,0,0,65,16,49,65,0
"Greenway township, Itasca County, Minnesota",2002,1964,2,77,0,0,4,2002,24,1978,1957,45
"Harris township, Itasca County, Minnesota",3250,3156,43,63,65,0,0,3250,38,3212,3173,77
"Keewatin city, Itasca County, Minnesota",1012,986,18,21,0,0,20,1012,25,987,979,33
"Kinghurst township, Itasca County, Minnesota",106,106,0,0,0,0,0,106,0,106,106,0
"Lake Jessie township, Itasca County, Minnesota",299,299,0,2,0,0,0,299,0,299,297,2
"La Prairie city, Itasca County, Minnesota",833,827,5,28,2,0,0,833,18,815,804,29
"Lawrence township, Itasca County, Minnesota",473,473,0,4,0,0,0,473,11,462,469,4
"Liberty UT, Itasca County, Minnesota",85,85,0,0,0,0,0,85,0,85,85,0
"Little Sand Lake UT, Itasca County, Minnesota",241,241,0,0,0,0,0,241,0,241,241,0
"Lone Pine township, Itasca County, Minnesota",423,416,4,7,7,0,0,423,9,414,416,7
"Marcell township, Itasca County, Minnesota",456,453,0,3,0,0,0,456,0,456,456,0
"Max township, Itasca County, Minnesota",136,110,0,19,10,0,0,136,0,136,133,3
"Moose Park township, Itasca County, Minnesota",67,67,0,2,0,0,0,67,0,67,65,2
"Morse township, Itasca County, Minnesota",656,573,7,93,0,0,0,656,3,653,646,10
"Nashwauk township, Itasca County, Minnesota",1818,1802,20,11,24,0,0,1818,18,1800,1784,34
"Nore township, Itasca County, Minnesota",81,59,1,22,0,0,0,81,0,81,80,1
"Northeast Itasca UT, Itasca County, Minnesota",1205,1162,82,54,0,0,0,1205,20,1185,1112,93
"Oteneagen township, Itasca County, Minnesota",319,298,4,20,9,0,0,319,1,318,307,12
"Pomroy township, Itasca County, Minnesota",16,16,0,0,0,0,0,16,0,16,16,0
"Sago township, Itasca County, Minnesota",197,194,0,1,0,0,5,197,5,192,194,3
"Sand Lake township, Itasca County, Minnesota",201,176,0,28,0,0,0,201,0,201,198,3
"Spang township, Itasca County, Minnesota",243,239,2,0,2,0,0,243,0,243,243,0
"Splithand township, Itasca County, Minnesota",271,264,2,7,0,0,0,271,10,261,269,2
"Squaw Lake city, Itasca County, Minnesota",151,41,0,103,5,7,0,151,0,151,146,5
"Stokes township, Itasca County, Minnesota",219,218,0,0,1,0,0,219,8,211,219,0
"Taconite city, Itasca County, Minnesota",648,632,18,22,8,0,0,648,0,648,616,32
"Third River township, Itasca County, Minnesota",64,64,0,0,0,0,0,64,0,64,64,0
"Trout Lake township, Itasca County, Minnesota",1091,1074,9,15,0,0,0,1091,0,1091,1084,7
"Wabana township, Itasca County, Minnesota",588,588,0,29,25,0,0,588,0,588,549,39
"Warba city, Itasca County, Minnesota",164,163,0,5,0,0,0,164,0,164,160,4
"Wawina township, Itasca County, Minnesota",66,66,0,0,0,0,0,66,0,66,66,0
"Wildwood township, Itasca County, Minnesota",146,142,0,0,4,0,0,146,0,146,146,0
"Wirt township, Itasca County, Minnesota",70,69,0,3,0,0,0,70,0,70,68,2
"Zemple city, Itasca County, Minnesota",106,94,0,12,0,0,0,106,0,106,106,0
"Alba township, Jackson County, Minnesota",189,165,0,0,0,0,24,189,25,164,189,0
"Alpha city, Jackson County, Minnesota",179,131,0,0,46,0,2,179,2,177,179,0
"Belmont township, Jackson County, Minnesota",211,211,9,0,0,0,0,211,0,211,202,9
"Christiania township, Jackson County, Minnesota",309,309,0,0,0,0,0,309,10,299,309,0
"Delafield township, Jackson County, Minnesota",227,227,0,0,0,0,0,227,0,227,227,0
"Des Moines township, Jackson County, Minnesota",206,205,1,0,0,0,0,206,0,206,206,0
"Enterprise township, Jackson County, Minnesota",151,148,0,0,3,0,0,151,0,151,151,0
"Ewington township, Jackson County, Minnesota",243,242,0,0,3,0,0,243,0,243,241,2
"Heron Lake city, Jackson County, Minnesota",724,683,0,0,0,2,44,724,88,636,719,5
"Heron Lake township, Jackson County, Minnesota",273,273,0,0,0,0,0,273,0,273,273,0
"Hunter township, Jackson County, Minnesota",210,210,3,0,0,0,0,210,0,210,207,3
"Jackson city, Jackson County, Minnesota",3250,3020,20,17,206,0,34,3250,111,3139,3203,47
"Kimball township, Jackson County, Minnesota",99,99,0,0,0,0,0,99,0,99,99,0
"La Crosse township, Jackson County, Minnesota",131,131,0,0,0,0,0,131,0,131,131,0
"Lakefield city, Jackson County, Minnesota",1703,1691,0,7,20,0,0,1703,29,1674,1688,15
"Middletown township, Jackson County, Minnesota",205,204,0,0,1,0,0,205,7,198,205,0
"Minneota township, Jackson County, Minnesota",245,241,0,0,4,0,0,245,0,245,245,0
"Okabena city, Jackson County, Minnesota",240,234,0,0,5,0,1,240,22,218,240,0
"Petersburg township, Jackson County, Minnesota",236,232,0,0,0,0,4,236,4,232,236,0
"Rost township, Jackson County, Minnesota",184,173,0,11,0,0,0,184,0,184,184,0
"Round Lake township, Jackson County, Minnesota",186,186,0,0,0,0,0,186,11,175,186,0
"Sioux Valley township, Jackson County, Minnesota",226,226,0,0,0,0,17,226,20,206,209,17
"Weimer township, Jackson County, Minnesota",156,156,0,0,0,0,0,156,14,142,156,0
"West Heron Lake township, Jackson County, Minnesota",83,83,0,0,0,0,0,83,0,83,83,0
"Wilder city, Jackson County, Minnesota",32,32,0,0,0,0,0,32,0,32,32,0
"Wisconsin township, Jackson County, Minnesota",206,206,1,0,0,0,0,206,0,206,205,1
"Ann Lake township, Kanabec County, Minnesota",429,419,5,17,3,0,1,429,5,424,415,14
"Arthur township, Kanabec County, Minnesota",1989,1928,5,12,14,0,33,1989,34,1955,1986,3
"Braham city, Kanabec County, Minnesota",0,0,0,0,0,0,0,0,0,0,0,0
"Brunswick township, Kanabec County, Minnesota",1315,1285,0,14,7,0,12,1315,29,1286,1312,3
"Comfort township, Kanabec County, Minnesota",1089,1079,0,0,10,0,0,1089,7,1082,1089,0
"Ford township, Kanabec County, Minnesota",163,154,0,5,4,0,0,163,0,163,163,0
"Grass Lake township, Kanabec County, Minnesota",958,946,20,21,0,0,3,958,17,941,926,32
"Grasston city, Kanabec County, Minnesota",224,224,2,2,0,0,0,224,0,224,220,4
"Hay Brook township, Kanabec County, Minnesota",283,283,0,0,0,0,0,283,0,283,283,0
"Hillman township, Kanabec County, Minnesota",417,390,9,25,0,0,0,417,0,417,410,7
"Kanabec township, Kanabec County, Minnesota",881,876,3,16,5,0,0,881,6,875,862,19
"Knife Lake township, Kanabec County, Minnesota",987,973,0,10,14,0,0,987,10,977,977,10
"Kroschel township, Kanabec County, Minnesota",202,202,0,0,0,0,0,202,0,202,202,0
"Mora city, Kanabec County, Minnesota",3468,3419,33,104,0,0,0,3468,65,3403,3406,62
"Ogilvie city, Kanabec County, Minnesota",392,381,7,4,3,2,0,392,8,384,387,5
"Peace township, Kanabec County, Minnesota",1018,992,50,6,0,0,0,1018,43,975,988,30
"Pomroy township, Kanabec County, Minnesota",349,340,0,8,0,0,1,349,1,348,349,0
"Quamba city, Kanabec County, Minnesota",163,146,16,17,0,0,0,163,16,147,149,14
"South Fork township, Kanabec County, Minnesota",886,825,18,3,50,30,0,886,4,882,846,40
"Whited township, Kanabec County, Minnesota",735,722,9,8,2,2,0,735,2,733,727,8
"Arctander township, Kandiyohi County, Minnesota",308,308,0,0,6,0,0,308,10,298,302,6
"Atwater city, Kandiyohi County, Minnesota",1048,1033,0,0,26,0,0,1048,52,996,1037,11
"Blomkest city, Kandiyohi County, Minnesota",123,123,0,0,0,0,0,123,5,118,123,0
"Burbank township, Kandiyohi County, Minnesota",466,466,0,2,0,0,0,466,4,462,464,2
"Colfax township, Kandiyohi County, Minnesota",661,647,0,11,0,0,3,661,3,658,661,0
"Dovre township, Kandiyohi County, Minnesota",2040,1955,0,3,7,0,78,2040,80,1960,2037,3
"East Lake Lillian township, Kandiyohi County, Minnesota",190,190,0,0,0,0,0,190,0,190,190,0
"Edwards township, Kandiyohi County, Minnesota",264,263,1,0,0,0,0,264,5,259,264,0
"Fahlun township, Kandiyohi County, Minnesota",447,447,0,0,0,0,0,447,0,447,447,0
"Gennessee township, Kandiyohi County, Minnesota",433,429,0,1,0,0,4,433,8,425,432,1
"Green Lake township, Kandiyohi County, Minnesota",1575,1500,74,57,0,0,0,1575,24,1551,1519,56
"Harrison township, Kandiyohi County, Minnesota",554,554,0,0,0,0,0,554,0,554,554,0
"Holland township, Kandiyohi County, Minnesota",398,398,0,7,0,0,0,398,0,398,391,7
"Irving township, Kandiyohi County, Minnesota",995,995,0,4,0,0,2,995,20,975,989,6
"Kandiyohi city, Kandiyohi County, Minnesota",590,570,14,3,0,0,5,590,9,581,588,2
"Kandiyohi township, Kandiyohi County, Minnesota",597,587,0,0,0,0,10,597,14,583,597,0
"Lake Andrew township, Kandiyohi County, Minnesota",1033,1030,0,2,0,0,3,1033,25,1008,1031,2
"Lake Elizabeth township, Kandiyohi County, Minnesota",173,173,7,0,0,0,0,173,2,171,166,7
"Lake Lillian city, Kandiyohi County, Minnesota",295,290,1,1,3,0,0,295,4,291,295,0
"Lake Lillian township, Kandiyohi County, Minnesota",202,197,0,0,5,0,0,202,4,198,202,0
"Mamre township, Kandiyohi County, Minnesota",528,525,5,0,0,0,6,528,56,472,520,8
"New London city, Kandiyohi County, Minnesota",1229,1205,0,8,0,0,24,1229,86,1143,1221,8
"New London township, Kandiyohi County, Minnesota",2955,2888,14,5,67,21,0,2955,11,2944,2915,40
"Norway Lake township, Kandiyohi County, Minnesota",244,244,0,1,0,0,0,244,0,244,243,1
"Pennock city, Kandiyohi County, Minnesota",496,445,0,3,0,0,50,496,121,375,494,2
"Prinsburg city, Kandiyohi County, Minnesota",532,503,6,2,12,0,11,532,11,521,530,2
"Raymond city, Kandiyohi County, Minnesota",689,661,4,10,19,0,27,689,53,636,657,32
"Regal city, Kandiyohi County, Minnesota",51,45,0,0,0,0,6,51,6,45,51,0
"Roseland township, Kandiyohi County, Minnesota",380,380,0,0,0,0,0,380,0,380,380,0
"Roseville township, Kandiyohi County, Minnesota",633,622,0,9,10,2,11,633,19,614,612,21
"St. Johns township, Kandiyohi County, Minnesota",380,350,0,0,36,0,2,380,19,361,372,8
"Spicer city, Kandiyohi County, Minnesota",1320,1320,0,9,0,0,0,1320,32,1288,1311,9
"Sunburg city, Kandiyohi County, Minnesota",75,75,0,0,0,0,0,75,0,75,75,0
"Whitefield township, Kandiyohi County, Minnesota",533,531,0,3,9,0,0,533,9,524,523,10
"Willmar city, Kandiyohi County, Minnesota",19608,15590,1976,249,251,0,1905,19608,4313,15295,19250,358
"Willmar township, Kandiyohi County, Minnesota",532,489,9,23,8,0,7,532,56,476,528,4
"Arveson township, Kittson County, Minnesota",41,41,0,0,0,0,0,41,0,41,41,0
"Cannon township, Kittson County, Minnesota",2,2,0,0,0,0,0,2,0,2,2,0
"Caribou township, Kittson County, Minnesota",35,35,0,0,0,0,0,35,0,35,35,0
"Clow township, Kittson County, Minnesota",70,70,0,0,0,0,0,70,0,70,70,0
"Davis township, Kittson County, Minnesota",25,25,0,0,0,0,0,25,0,25,25,0
"Deerwood township, Kittson County, Minnesota",146,145,1,0,0,0,0,146,0,146,146,0
"Donaldson city, Kittson County, Minnesota",10,10,0,0,0,0,0,10,0,10,10,0
"Granville township, Kittson County, Minnesota",34,34,0,0,0,0,0,34,0,34,34,0
"Hallock city, Kittson County, Minnesota",1088,1083,4,6,4,0,0,1088,44,1044,1079,9
"Hallock township, Kittson County, Minnesota",58,56,0,0,8,0,0,58,0,58,52,6
"Halma city, Kittson County, Minnesota",40,40,0,0,0,0,0,40,0,40,40,0
"Hampden township, Kittson County, Minnesota",35,35,0,0,0,0,0,35,0,35,35,0
"Hazelton township, Kittson County, Minnesota",62,62,0,0,0,0,0,62,0,62,62,0
"Hill township, Kittson County, Minnesota",5,5,0,0,0,0,0,5,0,5,5,0
"Humboldt city, Kittson County, Minnesota",20,20,0,0,3,0,0,20,0,20,17,3
"Jupiter township, Kittson County, Minnesota",70,70,0,0,0,0,0,70,0,70,70,0
"Karlstad city, Kittson County, Minnesota",851,826,21,12,0,0,0,851,0,851,843,8
"Kennedy city, Kittson County, Minnesota",272,270,0,0,0,0,2,272,2,270,272,0
"Klondike UT, Kittson County, Minnesota",0,0,0,0,0,0,0,0,0,0,0,0
"Lake Bronson city, Kittson County, Minnesota",231,230,0,1,0,0,0,231,0,231,231,0
"Lancaster city, Kittson County, Minnesota",367,367,0,1,0,0,0,367,39,328,366,1
"McKinley UT, Kittson County, Minnesota",18,18,0,0,0,0,0,18,0,18,18,0
"North Red River UT, Kittson County, Minnesota",0,0,0,0,0,0,0,0,0,0,0,0
"Norway township, Kittson County, Minnesota",105,101,2,0,0,0,2,105,0,105,105,0
"Peatland UT, Kittson County, Minnesota",5,5,0,0,0,0,0,5,0,5,5,0
"Pelan township, Kittson County, Minnesota",60,60,0,0,0,0,0,60,0,60,60,0
"Percy township, Kittson County, Minnesota",88,67,10,0,11,0,0,88,0,88,88,0
"Poppleton township, Kittson County, Minnesota",108,107,0,0,1,0,0,108,0,108,108,0
"Richardville township, Kittson County, Minnesota",80,80,0,0,0,0,2,80,0,80,78,2
"St. Joseph township, Kittson County, Minnesota",23,23,0,0,0,0,0,23,0,23,23,0
"St. Vincent city, Kittson County, Minnesota",43,40,3,0,1,0,0,43,0,43,42,1
"St. Vincent township, Kittson County, Minnesota",33,33,0,0,0,0,0,33,0,33,33,0
"Skane township, Kittson County, Minnesota",29,29,0,0,0,0,0,29,0,29,29,0
"South Red River township, Kittson County, Minnesota",2,2,0,0,0,0,0,2,0,2,2,0
"Spring Brook township, Kittson County, Minnesota",47,47,0,0,0,0,0,47,6,41,47,0
"Svea township, Kittson County, Minnesota",20,20,0,0,0,0,0,20,0,20,20,0
"Tegner township, Kittson County, Minnesota",25,25,0,0,0,0,0,25,0,25,25,0
"Teien township, Kittson County, Minnesota",37,37,0,0,0,0,0,37,0,37,37,0
"Thompson township, Kittson County, Minnesota",199,199,0,0,0,0,0,199,0,199,199,0
"Big Falls city, Koochiching County, Minnesota",278,276,0,9,0,0,0,278,0,278,271,7
"East Koochiching UT, Koochiching County, Minnesota",288,288,0,0,0,0,0,288,0,288,288,0
"International Falls city, Koochiching County, Minnesota",6121,5744,115,290,45,0,0,6121,0,6121,6048,73
"Littlefork city, Koochiching County, Minnesota",706,706,0,23,0,0,0,706,5,701,683,23
"Mizpah city, Koochiching County, Minnesota",127,123,0,20,0,0,0,127,0,127,111,16
"Nett Lake UT, Koochiching County, Minnesota",140,25,14,116,0,0,0,140,0,140,125,15
"Northome city, Koochiching County, Minnesota",254,221,0,31,2,0,0,254,0,254,254,0
"Northome UT, Koochiching County, Minnesota",534,477,0,61,2,0,0,534,0,534,528,6
"Northwest Koochiching UT, Koochiching County, Minnesota",492,480,0,3,12,0,0,492,5,487,489,3
"Rainy Lake UT, Koochiching County, Minnesota",3216,3180,0,36,0,0,0,3216,0,3216,3216,0
"Ranier city, Koochiching County, Minnesota",554,543,0,29,7,0,0,554,10,544,529,25
"South Koochiching UT, Koochiching County, Minnesota",66,66,0,5,0,0,0,66,0,66,61,5
"Agassiz township, Lac qui Parle County, Minnesota",49,49,0,0,0,0,0,49,0,49,49,0
"Arena township, Lac qui Parle County, Minnesota",82,82,0,0,0,0,0,82,0,82,82,0
"Augusta township, Lac qui Parle County, Minnesota",88,88,0,0,0,0,0,88,0,88,88,0
"Baxter township, Lac qui Parle County, Minnesota",167,167,0,0,0,0,0,167,0,167,167,0
"Bellingham city, Lac qui Parle County, Minnesota",238,210,0,0,0,0,28,238,32,206,238,0
"Boyd city, Lac qui Parle County, Minnesota",116,111,0,4,5,0,0,116,0,116,112,4
"Camp Release township, Lac qui Parle County, Minnesota",271,270,0,0,0,0,1,271,1,270,271,0
"Cerro Gordo township, Lac qui Parle County, Minnesota",138,136,0,0,2,0,0,138,0,138,138,0
"Dawson city, Lac qui Parle County, Minnesota",1631,1539,58,6,0,3,28,1631,76,1555,1628,3
"Freeland township, Lac qui Parle County, Minnesota",88,88,0,4,0,0,0,88,0,88,84,4
"Garfield township, Lac qui Parle County, Minnesota",95,95,0,0,0,0,0,95,0,95,95,0
"Hamlin township, Lac qui Parle County, Minnesota",153,153,0,0,0,0,0,153,0,153,153,0
"Hantho township, Lac qui Parle County, Minnesota",83,83,0,7,0,0,0,83,0,83,76,7
"Lac qui Parle township, Lac qui Parle County, Minnesota",152,152,0,0,0,0,0,152,0,152,152,0
"Lake Shore township, Lac qui Parle County, Minnesota",160,157,0,0,0,0,9,160,26,134,154,6
"Louisburg city, Lac qui Parle County, Minnesota",39,39,0,0,0,0,0,39,0,39,39,0
"Madison city, Lac qui Parle County, Minnesota",1574,1539,33,6,13,0,0,1574,6,1568,1557,17
"Madison township, Lac qui Parle County, Minnesota",164,164,0,0,0,0,0,164,0,164,164,0
"Manfred township, Lac qui Parle County, Minnesota",86,86,0,0,0,0,0,86,0,86,86,0
"Marietta city, Lac qui Parle County, Minnesota",169,164,0,5,1,0,0,169,0,169,168,1
"Maxwell township, Lac qui Parle County, Minnesota",121,121,0,0,0,0,0,121,0,121,121,0
"Mehurin township, Lac qui Parle County, Minnesota",102,102,0,0,0,0,0,102,0,102,102,0
"Nassau city, Lac qui Parle County, Minnesota",77,77,0,0,0,0,0,77,0,77,77,0
"Perry township, Lac qui Parle County, Minnesota",64,55,0,0,9,0,0,64,0,64,64,0
"Providence township, Lac qui Parle County, Minnesota",182,182,0,0,0,0,0,182,0,182,182,0
"Riverside township, Lac qui Parle County, Minnesota",313,313,0,0,0,0,0,313,3,310,313,0
"Ten Mile Lake township, Lac qui Parle County, Minnesota",153,153,2,0,0,0,0,153,0,153,151,2
"Walter township, Lac qui Parle County, Minnesota",144,144,0,0,0,0,0,144,0,144,144,0
"Yellow Bank township, Lac qui Parle County, Minnesota",141,141,0,0,0,0,0,141,0,141,141,0
"County subdivisions not defined, Lake County, Minnesota",0,0,0,0,0,0,0,0,0,0,0,0
"Beaver Bay city, Lake County, Minnesota",100,94,0,2,0,4,0,100,0,100,100,0
"Beaver Bay township, Lake County, Minnesota",458,458,0,6,0,3,0,458,32,426,449,9
"Crystal Bay township, Lake County, Minnesota",518,514,4,3,0,0,0,518,29,489,515,3
"Fall Lake township, Lake County, Minnesota",682,682,0,3,0,0,0,682,1,681,679,3
"Lake No. 1 UT, Lake County, Minnesota",47,47,0,0,0,0,0,47,0,47,47,0
"Lake No. 2 UT, Lake County, Minnesota",2057,2037,0,20,0,0,0,2057,0,2057,2057,0
"Silver Bay city, Lake County, Minnesota",1724,1668,49,10,0,0,31,1724,51,1673,1690,34
"Silver Creek township, Lake County, Minnesota",1265,1240,0,17,6,0,17,1265,17,1248,1250,15
"Stony River township, Lake County, Minnesota",176,165,0,12,0,0,0,176,22,154,175,1
"Two Harbors city, Lake County, Minnesota",3551,3458,106,51,12,0,1,3551,1,3550,3495,56
"Angle township, Lake of the Woods County, Minnesota",17,17,0,0,0,0,0,17,0,17,17,0
"Baudette city, Lake of the Woods County, Minnesota",1004,999,18,21,40,0,58,1004,66,938,872,132
"Baudette township, Lake of the Woods County, Minnesota",423,423,0,47,0,0,0,423,1,422,376,47
"Boone township, Lake of the Woods County, Minnesota",0,0,0,0,0,0,0,0,0,0,0,0
"Chilgren township, Lake of the Woods County, Minnesota",227,202,0,0,25,0,0,227,0,227,227,0
"Forest Area township, Lake of the Woods County, Minnesota",0,0,0,0,0,0,0,0,0,0,0,0
"Gudrid township, Lake of the Woods County, Minnesota",257,257,0,0,0,0,0,257,0,257,257,0
"Kiel township, Lake of the Woods County, Minnesota",0,0,0,0,0,0,0,0,0,0,0,0
"Lakewood township, Lake of the Woods County, Minnesota",0,0,0,0,0,0,0,0,0,0,0,0
"McDougald township, Lake of the Woods County, Minnesota",189,189,0,0,0,0,0,189,0,189,189,0
"Myhre township, Lake of the Woods County, Minnesota",232,232,0,0,0,0,0,232,0,232,232,0
"Potamo township, Lake of the Woods County, Minnesota",202,202,0,0,0,0,0,202,0,202,202,0
"Prosper township, Lake of the Woods County, Minnesota",217,217,0,18,0,0,0,217,0,217,199,18
"Rapid River township, Lake of the Woods County, Minnesota",13,6,0,7,0,0,0,13,0,13,13,0
"Roosevelt city, Lake of the Woods County, Minnesota",0,0,0,0,0,0,0,0,0,0,0,0
"Rulien township, Lake of the Woods County, Minnesota",0,0,0,0,0,0,0,0,0,0,0,0
"Spooner township, Lake of the Woods County, Minnesota",175,175,0,0,0,0,0,175,0,175,175,0
"Swiftwater township, Lake of the Woods County, Minnesota",33,33,0,0,0,0,0,33,0,33,33,0
"Township 157-30, Lake of the Woods County, Minnesota",0,0,0,0,0,0,0,0,0,0,0,0
"Township 158-30, Lake of the Woods County, Minnesota",0,0,0,0,0,0,0,0,0,0,0,0
"Victory township, Lake of the Woods County, Minnesota",0,0,0,0,0,0,0,0,0,0,0,0
"Wabanica township, Lake of the Woods County, Minnesota",329,329,0,13,0,0,0,329,0,329,316,13
"Walhalla township, Lake of the Woods County, Minnesota",34,34,0,0,0,0,0,34,0,34,34,0
"Wheeler township, Lake of the Woods County, Minnesota",205,205,0,0,0,0,0,205,0,205,205,0
"Williams city, Lake of the Woods County, Minnesota",106,106,0,2,0,0,0,106,0,106,104,2
"Zippel township, Lake of the Woods County, Minnesota",178,178,0,0,0,0,0,178,0,178,178,0
"Cleveland city, Le Sueur County, Minnesota",712,709,3,0,0,0,6,712,13,699,706,6
"Cleveland township, Le Sueur County, Minnesota",629,624,0,0,5,0,0,629,0,629,629,0
"Cordova township, Le Sueur County, Minnesota",502,500,0,0,2,0,0,502,0,502,502,0
"Derrynane township, Le Sueur County, Minnesota",351,351,0,0,0,0,0,351,0,351,351,0
"Elysian city, Le Sueur County, Minnesota",701,698,0,0,0,3,0,701,0,701,701,0
"Elysian township, Le Sueur County, Minnesota",1032,1028,0,0,17,0,0,1032,71,961,1019,13
"Heidelberg city, Le Sueur County, Minnesota",119,119,0,0,0,0,0,119,0,119,119,0
"Kasota city, Le Sueur County, Minnesota",758,681,74,0,8,0,2,758,7,751,751,7
"Kasota township, Le Sueur County, Minnesota",1500,1500,0,0,0,0,0,1500,25,1475,1500,0
"Kilkenny city, Le Sueur County, Minnesota",192,192,0,0,0,0,0,192,3,189,192,0
"Kilkenny township, Le Sueur County, Minnesota",389,389,11,11,0,2,0,389,2,387,376,13
"Lanesburgh township, Le Sueur County, Minnesota",1988,1976,0,3,27,0,0,1988,21,1967,1970,18
"Le Center city, Le Sueur County, Minnesota",2504,2300,32,8,5,0,170,2504,608,1896,2493,11
"Le Sueur city, Le Sueur County, Minnesota",4000,3802,0,20,133,0,126,4000,567,3433,3919,81
"Lexington township, Le Sueur County, Minnesota",757,754,15,0,3,0,0,757,21,736,742,15
"Mankato city, Le Sueur County, Minnesota",0,0,0,0,0,0,0,0,0,0,0,0
"Montgomery city, Le Sueur County, Minnesota",2921,2748,94,110,25,12,36,2921,114,2807,2822,99
"Montgomery township, Le Sueur County, Minnesota",731,731,0,0,0,0,2,731,4,727,729,2
"New Prague city, Le Sueur County, Minnesota",3091,3080,0,32,0,0,0,3091,69,3022,3070,21
"Ottawa township, Le Sueur County, Minnesota",325,325,0,0,0,0,0,325,0,325,325,0
"Sharon township, Le Sueur County, Minnesota",632,628,7,10,4,0,0,632,2,630,615,17
"Tyrone township, Le Sueur County, Minnesota",567,567,0,0,0,0,4,567,4,563,563,4
"Washington township, Le Sueur County, Minnesota",745,728,9,0,6,0,2,745,5,740,745,0
"Waterville city, Le Sueur County, Minnesota",1954,1894,46,6,20,0,0,1954,53,1901,1942,12
"Waterville township, Le Sueur County, Minnesota",710,703,0,0,0,0,7,710,8,702,710,0
"Alta Vista township, Lincoln County, Minnesota",114,114,0,0,0,0,0,114,0,114,114,0
"Arco city, Lincoln County, Minnesota",98,96,0,2,0,0,0,98,0,98,98,0
"Ash Lake township, Lincoln County, Minnesota",139,139,0,0,0,0,0,139,5,134,139,0
"Diamond Lake township, Lincoln County, Minnesota",142,142,0,0,0,0,0,142,0,142,142,0
"Drammen township, Lincoln County, Minnesota",110,110,0,0,0,0,0,110,0,110,110,0
"Hansonville township, Lincoln County, Minnesota",85,85,0,0,0,0,0,85,0,85,85,0
"Hendricks city, Lincoln County, Minnesota",799,752,17,33,0,0,16,799,49,750,780,19
"Hendricks township, Lincoln County, Minnesota",197,197,0,0,0,0,0,197,0,197,197,0
"Hope township, Lincoln County, Minnesota",313,311,0,0,4,0,0,313,0,313,311,2
"Ivanhoe city, Lincoln County, Minnesota",586,579,6,1,1,0,0,586,0,586,585,1
"Lake Benton city, Lincoln County, Minnesota",718,716,0,3,12,0,2,718,7,711,703,15
"Lake Benton township, Lincoln County, Minnesota",207,207,1,0,0,0,0,207,0,207,206,1
"Lake Stay township, Lincoln County, Minnesota",171,171,0,0,0,0,0,171,0,171,171,0
"Limestone township, Lincoln County, Minnesota",64,64,0,0,0,0,0,64,0,64,64,0
"Marble township, Lincoln County, Minnesota",126,125,0,1,0,0,0,126,0,126,126,0
"Marshfield township, Lincoln County, Minnesota",195,195,0,0,0,0,0,195,2,193,195,0
"Royal township, Lincoln County, Minnesota",109,109,0,0,0,0,0,109,0,109,109,0
"Shaokatan township, Lincoln County, Minnesota",148,142,0,1,0,0,5,148,6,142,148,0
"Tyler city, Lincoln County, Minnesota",1284,1260,16,5,7,0,0,1284,30,1254,1280,4
"Verdi township, Lincoln County, Minnesota",119,119,0,0,0,0,0,119,0,119,119,0
"Amiret township, Lyon County, Minnesota",204,201,3,0,0,0,0,204,0,204,204,0
"Balaton city, Lyon County, Minnesota",590,576,11,14,0,0,0,590,4,586,579,11
"Clifton township, Lyon County, Minnesota",229,214,0,3,12,0,0,229,0,229,229,0
"Coon Creek township, Lyon County, Minnesota",226,224,0,2,0,0,2,226,11,215,224,2
"Cottonwood city, Lyon County, Minnesota",1215,1143,0,0,23,0,52,1215,118,1097,1212,3
"Custer township, Lyon County, Minnesota",160,160,0,0,0,0,0,160,0,160,160,0
"Eidsvold township, Lyon County, Minnesota",267,265,0,0,0,0,2,267,4,263,267,0
"Fairview township, Lyon County, Minnesota",348,348,2,3,13,0,0,348,17,331,330,18
"Florence city, Lyon County, Minnesota",28,28,0,0,0,0,0,28,9,19,28,0
"Garvin city, Lyon County, Minnesota",127,127,0,0,0,0,0,127,2,125,127,0
"Ghent city, Lyon County, Minnesota",354,309,4,0,0,0,41,354,43,311,354,0
"Grandview township, Lyon County, Minnesota",319,314,2,0,5,0,2,319,2,317,315,4
"Island Lake township, Lyon County, Minnesota",160,160,0,0,0,0,0,160,0,160,160,0
"Lake Marshall township, Lyon County, Minnesota",528,506,19,0,0,0,3,528,12,516,528,0
"Lucas township, Lyon County, Minnesota",221,213,0,0,8,0,0,221,0,221,221,0
"Lynd city, Lyon County, Minnesota",512,396,24,2,26,1,75,512,75,437,502,10
"Lynd township, Lyon County, Minnesota",378,376,2,8,2,0,0,378,0,378,368,10
"Lyons township, Lyon County, Minnesota",163,163,0,0,0,0,0,163,0,163,163,0
"Marshall city, Lyon County, Minnesota",13706,11718,887,129,721,25,557,13706,1160,12546,13420,286
"Minneota city, Lyon County, Minnesota",1364,1317,10,2,19,0,23,1364,90,1274,1359,5
"Monroe township, Lyon County, Minnesota",243,242,0,0,1,0,0,243,4,239,243,0
"Nordland township, Lyon County, Minnesota",244,244,0,16,0,0,0,244,0,244,228,16
"Rock Lake township, Lyon County, Minnesota",327,303,0,0,0,0,24,327,24,303,327,0
"Russell city, Lyon County, Minnesota",384,353,3,8,27,0,0,384,0,384,377,7
"Shelburne township, Lyon County, Minnesota",195,195,0,3,0,0,0,195,0,195,192,3
"Sodus township, Lyon County, Minnesota",340,340,0,0,0,0,0,340,0,340,340,0
"Stanley township, Lyon County, Minnesota",211,209,0,9,1,0,0,211,2,209,203,8
"Taunton city, Lyon County, Minnesota",156,148,14,0,0,0,0,156,5,151,150,6
"Tracy city, Lyon County, Minnesota",2142,1894,0,28,236,0,10,2142,21,2121,2116,26
"Vallers township, Lyon County, Minnesota",195,193,1,2,0,0,1,195,1,194,193,2
"Westerheim township, Lyon County, Minnesota",253,253,0,0,0,0,0,253,0,253,253,0
"Acoma township, McLeod County, Minnesota",1139,1133,0,0,6,0,0,1139,6,1133,1139,0
"Bergen township, McLeod County, Minnesota",838,835,0,0,3,0,0,838,52,786,838,0
"Biscay city, McLeod County, Minnesota",111,88,0,0,0,0,23,111,23,88,111,0
"Brownton city, McLeod County, Minnesota",806,753,28,12,10,0,3,806,88,718,806,0
"Collins township, McLeod County, Minnesota",397,393,0,0,9,0,3,397,3,394,389,8
"Glencoe city, McLeod County, Minnesota",5511,5057,59,161,26,26,465,5511,632,4879,5332,179
"Glencoe township, McLeod County, Minnesota",450,439,0,5,0,0,6,450,10,440,450,0
"Hale township, McLeod County, Minnesota",853,851,2,0,0,0,0,853,0,853,853,0
"Hassan Valley township, McLeod County, Minnesota",589,587,0,0,0,4,2,589,0,589,585,4
"Helen township, McLeod County, Minnesota",853,842,0,0,6,0,7,853,28,825,852,1
"Hutchinson city, McLeod County, Minnesota",13836,13510,308,63,227,0,96,13836,459,13377,13504,332
"Hutchinson township, McLeod County, Minnesota",1180,1157,0,0,31,0,0,1180,4,1176,1172,8
"Lester Prairie city, McLeod County, Minnesota",2015,1928,10,0,10,0,87,2015,539,1476,1995,20
"Lynn township, McLeod County, Minnesota",504,503,0,0,9,0,0,504,7,497,496,8
"Penn township, McLeod County, Minnesota",332,329,0,0,3,0,0,332,33,299,332,0
"Plato city, McLeod County, Minnesota",287,275,0,0,0,0,12,287,19,268,287,0
"Rich Valley township, McLeod County, Minnesota",787,743,5,6,31,0,20,787,37,750,769,18
"Round Grove township, McLeod County, Minnesota",222,219,0,0,0,0,3,222,3,219,222,0
"Silver Lake city, McLeod County, Minnesota",894,889,6,12,5,0,0,894,23,871,876,18
"Stewart city, McLeod County, Minnesota",535,514,7,8,11,0,11,535,36,499,521,14
"Sumter township, McLeod County, Minnesota",494,494,0,0,0,0,0,494,12,482,494,0
"Winsted city, McLeod County, Minnesota",2377,2363,6,0,0,0,8,2377,39,2338,2377,0
"Winsted township, McLeod County, Minnesota",806,806,0,0,0,0,0,806,7,799,806,0
"Beaulieu township, Mahnomen County, Minnesota",80,43,2,46,0,0,0,80,0,80,69,11
"Bejou city, Mahnomen County, Minnesota",74,69,0,6,0,0,0,74,0,74,73,1
"Bejou township, Mahnomen County, Minnesota",54,54,0,0,0,0,0,54,0,54,54,0
"Chief township, Mahnomen County, Minnesota",60,50,2,8,0,0,4,60,0,60,56,4
"Clover township, Mahnomen County, Minnesota",76,36,7,51,0,0,0,76,0,76,63,13
"Gregory township, Mahnomen County, Minnesota",47,39,0,8,0,0,0,47,0,47,47,0
"Heier township, Mahnomen County, Minnesota",175,174,0,12,0,0,0,175,8,167,164,11
"Island Lake township, Mahnomen County, Minnesota",325,269,0,54,0,0,32,325,32,293,295,30
"La Garde township, Mahnomen County, Minnesota",118,77,0,39,1,0,3,118,12,106,116,2
"Lake Grove township, Mahnomen County, Minnesota",233,154,0,94,5,5,0,233,8,225,213,20
"Little Elbow township, Mahnomen County, Minnesota",249,83,7,182,0,0,0,249,0,249,231,18
"Mahnomen city, Mahnomen County, Minnesota",1257,693,20,647,8,4,7,1257,24,1233,1135,122
"Marsh Creek township, Mahnomen County, Minnesota",122,114,6,8,0,0,0,122,0,122,116,6
"Oakland township, Mahnomen County, Minnesota",293,171,0,140,4,0,0,293,9,284,271,22
"Pembina township, Mahnomen County, Minnesota",779,444,53,407,7,0,0,779,70,709,647,132
"Popple Grove township, Mahnomen County, Minnesota",151,129,0,27,0,0,0,151,0,151,146,5
"Rosedale township, Mahnomen County, Minnesota",165,144,0,40,1,0,0,165,0,165,145,20
"Twin Lakes township, Mahnomen County, Minnesota",741,87,0,666,7,9,0,741,23,718,713,28
"Waubun city, Mahnomen County, Minnesota",501,207,5,321,0,12,11,501,25,476,446,55
"Agder township, Marshall County, Minnesota",154,154,0,0,0,0,0,154,0,154,154,0
"Alma township, Marshall County, Minnesota",35,35,0,0,0,0,0,35,0,35,35,0
"Alvarado city, Marshall County, Minnesota",467,438,4,1,0,0,26,467,72,395,465,2
"Argyle city, Marshall County, Minnesota",708,706,0,4,0,0,0,708,23,685,706,2
"Augsburg township, Marshall County, Minnesota",72,72,0,6,0,0,0,72,0,72,66,6
"Big Woods township, Marshall County, Minnesota",32,32,0,0,0,0,0,32,0,32,32,0
"Bloomer township, Marshall County, Minnesota",74,72,0,0,0,0,6,74,6,68,70,4
"Boxville township, Marshall County, Minnesota",24,23,1,0,0,0,0,24,0,24,24,0
"Cedar township, Marshall County, Minnesota",40,40,0,0,0,0,0,40,0,40,40,0
"Como township, Marshall County, Minnesota",51,49,0,19,0,0,0,51,0,51,34,17
"Comstock township, Marshall County, Minnesota",89,89,0,0,0,0,0,89,0,89,89,0
"Donnelly township, Marshall County, Minnesota",11,11,0,0,0,0,0,11,0,11,11,0
"Eagle Point township, Marshall County, Minnesota",0,0,0,0,0,0,0,0,0,0,0,0
"East Park township, Marshall County, Minnesota",7,7,0,0,0,0,0,7,0,7,7,0
"East Valley township, Marshall County, Minnesota",27,27,0,0,0,0,0,27,0,27,27,0
"Eckvoll township, Marshall County, Minnesota",63,63,0,0,0,0,0,63,0,63,63,0
"Espelie township, Marshall County, Minnesota",18,18,0,0,0,0,0,18,0,18,18,0
"Excel township, Marshall County, Minnesota",342,342,0,6,0,0,0,342,0,342,336,6
"Foldahl township, Marshall County, Minnesota",36,36,0,0,0,0,0,36,0,36,36,0
"Fork township, Marshall County, Minnesota",4,4,0,0,0,0,0,4,0,4,4,0
"Grand Plain township, Marshall County, Minnesota",40,40,0,0,0,0,0,40,0,40,40,0
"Grygla city, Marshall County, Minnesota",145,144,0,2,1,0,0,145,5,140,144,1
"Holt city, Marshall County, Minnesota",129,124,0,5,0,0,0,129,2,127,129,0
"Holt township, Marshall County, Minnesota",209,209,0,21,0,0,0,209,0,209,188,21
"Huntly township, Marshall County, Minnesota",64,64,0,0,0,0,0,64,0,64,64,0
"Lincoln township, Marshall County, Minnesota",122,122,0,0,0,0,0,122,0,122,122,0
"Linsell township, Marshall County, Minnesota",25,25,0,0,0,0,0,25,0,25,25,0
"McCrea township, Marshall County, Minnesota",290,290,2,3,0,0,0,290,4,286,285,5
"Marsh Grove township, Marshall County, Minnesota",110,110,0,0,0,0,0,110,0,110,110,0
"Middle River city, Marshall County, Minnesota",270,270,0,1,0,0,0,270,0,270,269,1
"Middle River township, Marshall County, Minnesota",84,84,0,0,0,0,0,84,0,84,84,0
"Moose River township, Marshall County, Minnesota",23,23,0,7,0,0,0,23,0,23,16,7
"Moylan township, Marshall County, Minnesota",149,140,14,0,5,5,0,149,5,144,144,5
"Mud Lake UT, Marshall County, Minnesota",0,0,0,0,0,0,0,0,0,0,0,0
"Nelson Park township, Marshall County, Minnesota",96,96,2,9,0,0,0,96,2,94,87,9
"Newfolden city, Marshall County, Minnesota",385,383,7,2,0,0,0,385,0,385,378,7
"New Folden township, Marshall County, Minnesota",230,230,0,1,0,0,0,230,0,230,229,1
"New Maine township, Marshall County, Minnesota",278,278,0,0,0,0,0,278,2,276,278,0
"New Solum township, Marshall County, Minnesota",287,278,0,6,5,0,0,287,8,279,285,2
"Oak Park township, Marshall County, Minnesota",154,154,0,0,0,0,0,154,0,154,154,0
"Oslo city, Marshall County, Minnesota",242,236,4,2,0,0,0,242,43,199,242,0
"Parker township, Marshall County, Minnesota",40,40,0,0,0,0,0,40,0,40,40,0
"Rollis township, Marshall County, Minnesota",95,95,0,0,0,0,0,95,0,95,95,0
"Sinnott township, Marshall County, Minnesota",19,19,0,0,0,0,0,19,0,19,19,0
"Spruce Valley township, Marshall County, Minnesota",252,252,5,0,0,0,0,252,0,252,247,5
"Stephen city, Marshall County, Minnesota",676,658,11,0,18,0,5,676,145,531,665,11
"Strandquist city, Marshall County, Minnesota",83,83,0,0,0,0,0,83,0,83,83,0
"Tamarac township, Marshall County, Minnesota",52,52,0,0,0,0,0,52,0,52,52,0
"Thief Lake township, Marshall County, Minnesota",33,30,3,0,0,0,0,33,0,33,33,0
"Valley township, Marshall County, Minnesota",120,120,7,0,0,0,0,120,4,116,113,7
"Vega township, Marshall County, Minnesota",130,128,0,0,0,0,2,130,2,128,130,0
"Veldt township, Marshall County, Minnesota",18,18,0,0,0,0,0,18,0,18,18,0
"Viking city, Marshall County, Minnesota",108,106,0,0,0,0,6,108,10,98,104,4
"Viking township, Marshall County, Minnesota",139,136,0,0,0,3,0,139,0,139,139,0
"Wanger township, Marshall County, Minnesota",80,80,0,0,0,0,0,80,0,80,80,0
"Warren city, Marshall County, Minnesota",1631,1587,21,11,2,0,26,1631,62,1569,1615,16
"Warrenton township, Marshall County, Minnesota",76,76,0,0,0,0,0,76,0,76,76,0
"West Valley township, Marshall County, Minnesota",137,137,0,0,0,0,0,137,2,135,137,0
"Whiteford township, Marshall County, Minnesota",47,47,0,0,0,0,0,47,0,47,47,0
"Wright township, Marshall County, Minnesota",75,75,0,1,0,0,0,75,0,75,74,1
"Cedar township, Martin County, Minnesota",200,197,0,0,3,0,0,200,0,200,200,0
"Center Creek township, Martin County, Minnesota",230,230,0,0,0,0,0,230,0,230,230,0
"Ceylon city, Martin County, Minnesota",340,309,0,2,9,0,28,340,41,299,332,8
"Dunnell city, Martin County, Minnesota",157,155,0,2,0,0,0,157,13,144,157,0
"East Chain township, Martin County, Minnesota",299,299,0,0,4,0,0,299,0,299,295,4
"Elm Creek township, Martin County, Minnesota",196,193,0,3,0,0,0,196,0,196,196,0
"Fairmont city, Martin County, Minnesota",10251,9980,97,13,215,0,82,10251,641,9610,10120,131
"Fairmont township, Martin County, Minnesota",330,330,0,0,0,0,0,330,9,321,330,0
"Fox Lake township, Martin County, Minnesota",248,247,0,1,0,0,0,248,0,248,248,0
"Fraser township, Martin County, Minnesota",273,271,0,2,0,0,0,273,0,273,273,0
"Galena township, Martin County, Minnesota",179,179,0,0,0,0,4,179,4,175,175,4
"Granada city, Martin County, Minnesota",293,287,4,2,0,0,0,293,3,290,293,0
"Jay township, Martin County, Minnesota",227,227,0,0,0,0,0,227,0,227,227,0
"Lake Belt township, Martin County, Minnesota",153,153,0,2,0,0,0,153,0,153,151,2
"Lake Fremont township, Martin County, Minnesota",208,177,26,0,0,5,0,208,6,202,208,0
"Manyaska township, Martin County, Minnesota",357,357,0,0,0,0,0,357,0,357,357,0
"Nashville township, Martin County, Minnesota",235,235,0,0,0,0,0,235,49,186,235,0
"Northrop city, Martin County, Minnesota",198,198,0,0,0,0,0,198,0,198,198,0
"Ormsby city, Martin County, Minnesota",21,21,0,0,0,0,0,21,0,21,21,0
"Pleasant Prairie township, Martin County, Minnesota",230,230,0,0,3,0,0,230,0,230,227,3
"Rolling Green township, Martin County, Minnesota",199,199,0,1,2,0,0,199,0,199,196,3
"Rutland township, Martin County, Minnesota",448,438,4,0,5,0,6,448,6,442,443,5
"Sherburn city, Martin County, Minnesota",1085,1079,4,0,5,0,0,1085,5,1080,1082,3
"Silver Lake township, Martin County, Minnesota",463,463,0,0,2,0,0,463,0,463,461,2
"Tenhassen township, Martin County, Minnesota",256,256,0,0,0,0,0,256,5,251,256,0
"Trimont city, Martin County, Minnesota",775,764,16,3,2,2,7,775,13,762,756,19
"Truman city, Martin County, Minnesota",1051,1044,21,6,0,0,0,1051,7,1044,1037,14
"Waverly township, Martin County, Minnesota",191,191,0,0,0,0,0,191,0,191,191,0
"Welcome city, Martin County, Minnesota",689,683,6,3,3,0,0,689,22,667,686,3
"Westford township, Martin County, Minnesota",302,299,3,0,0,0,0,302,5,297,302,0
"Acton township, Meeker County, Minnesota",390,370,3,0,9,0,11,390,59,331,387,3
"Cedar Mills city, Meeker County, Minnesota",48,48,0,0,0,0,0,48,0,48,48,0
"Cedar Mills township, Meeker County, Minnesota",420,418,0,0,2,0,2,420,11,409,418,2
"Collinwood township, Meeker County, Minnesota",1230,1226,4,0,4,0,4,1230,9,1221,1226,4
"Cosmos city, Meeker County, Minnesota",509,481,26,2,4,0,0,509,8,501,505,4
"Cosmos township, Meeker County, Minnesota",234,234,0,0,0,0,0,234,26,208,234,0
"Danielson township, Meeker County, Minnesota",292,286,3,0,5,3,4,292,8,284,289,3
"Darwin city, Meeker County, Minnesota",291,291,0,0,0,0,2,291,23,268,289,2
"Darwin township, Meeker County, Minnesota",588,588,0,4,0,0,0,588,4,584,584,4
"Dassel city, Meeker County, Minnesota",1454,1438,0,27,52,0,4,1454,96,1358,1391,63
"Dassel township, Meeker County, Minnesota",1531,1501,0,0,6,0,38,1531,47,1484,1517,14
"Eden Valley city, Meeker County, Minnesota",527,527,0,27,0,0,0,527,0,527,500,27
"Ellsworth township, Meeker County, Minnesota",813,786,0,11,12,0,7,813,10,803,810,3
"Forest City township, Meeker County, Minnesota",584,580,0,7,0,0,11,584,17,567,570,14
"Forest Prairie township, Meeker County, Minnesota",990,987,17,0,0,0,3,990,8,982,973,17
"Greenleaf township, Meeker County, Minnesota",675,671,0,0,4,0,0,675,3,672,675,0
"Grove City city, Meeker County, Minnesota",638,629,0,0,4,0,9,638,31,607,634,4
"Harvey township, Meeker County, Minnesota",409,406,0,0,3,0,0,409,2,407,409,0
"Kingston city, Meeker County, Minnesota",173,170,0,3,3,0,0,173,4,169,170,3
"Kingston township, Meeker County, Minnesota",1294,1288,0,0,6,0,0,1294,0,1294,1294,0
"Litchfield city, Meeker County, Minnesota",6645,6462,156,41,0,0,16,6645,446,6199,6615,30
"Litchfield township, Meeker County, Minnesota",897,884,0,1,0,40,0,897,10,887,869,28
"Manannah township, Meeker County, Minnesota",560,545,0,0,15,0,3,560,3,557,557,3
"Swede Grove township, Meeker County, Minnesota",340,340,0,0,0,0,0,340,20,320,340,0
"Union Grove township, Meeker County, Minnesota",660,660,0,0,0,0,0,660,15,645,660,0
"Watkins city, Meeker County, Minnesota",913,913,11,5,0,0,0,913,7,906,897,16
"Bock city, Mille Lacs County, Minnesota",108,106,0,2,0,0,0,108,0,108,108,0
"Bogus Brook township, Mille Lacs County, Minnesota",1476,1457,15,20,0,0,0,1476,32,1444,1460,16
"Borgholm township, Mille Lacs County, Minnesota",1758,1707,0,11,51,0,0,1758,5,1753,1747,11
"Bradbury township, Mille Lacs County, Minnesota",290,288,3,10,0,0,0,290,3,287,279,11
"Dailey township, Mille Lacs County, Minnesota",176,175,0,1,0,0,0,176,0,176,176,0
"East Side township, Mille Lacs County, Minnesota",600,597,0,3,0,0,0,600,3,597,600,0
"Foreston city, Mille Lacs County, Minnesota",571,565,3,0,0,0,3,571,3,568,571,0
"Greenbush township, Mille Lacs County, Minnesota",1221,1166,4,48,10,0,3,1221,11,1210,1211,10
"Hayland township, Mille Lacs County, Minnesota",595,592,0,0,0,0,3,595,1,594,595,0
"Isle city, Mille Lacs County, Minnesota",789,630,22,169,3,1,0,789,38,751,754,35
"Isle Harbor township, Mille Lacs County, Minnesota",499,476,0,35,0,2,0,499,15,484,485,14
"Kathio township, Mille Lacs County, Minnesota",1353,513,52,780,42,0,11,1353,43,1310,1308,45
"Lewis township, Mille Lacs County, Minnesota",35,35,0,0,0,0,0,35,0,35,35,0
"Milaca city, Mille Lacs County, Minnesota",2881,2832,68,149,0,0,5,2881,74,2807,2708,173
"Milaca township, Mille Lacs County, Minnesota",1678,1660,2,42,8,0,0,1678,76,1602,1644,34
"Milo township, Mille Lacs County, Minnesota",1488,1476,4,3,10,0,0,1488,27,1461,1483,5
"Mudgett township, Mille Lacs County, Minnesota",58,57,0,1,0,0,0,58,0,58,58,0
"Onamia city, Mille Lacs County, Minnesota",939,825,63,145,11,0,0,939,19,920,850,89
"Onamia township, Mille Lacs County, Minnesota",521,506,2,15,0,0,0,521,3,518,519,2
"Page township, Mille Lacs County, Minnesota",713,703,9,18,5,2,7,713,27,686,688,25
"Pease city, Mille Lacs County, Minnesota",223,214,0,0,9,0,0,223,0,223,223,0
"Princeton city, Mille Lacs County, Minnesota",4589,4463,36,167,78,20,23,4589,161,4428,4391,198
"Princeton township, Mille Lacs County, Minnesota",2130,2081,22,30,9,0,0,2130,9,2121,2118,12
"South Harbor township, Mille Lacs County, Minnesota",727,628,17,126,2,0,4,727,20,707,677,50
"Wahkon city, Mille Lacs County, Minnesota",217,208,5,7,0,0,0,217,4,213,214,3
"Agram township, Morrison County, Minnesota",476,466,0,0,12,0,0,476,2,474,474,2
"Belle Prairie township, Morrison County, Minnesota",698,698,17,12,0,0,0,698,22,676,681,17
"Bellevue township, Morrison County, Minnesota",973,955,5,13,0,0,0,973,6,967,973,0
"Bowlus city, Morrison County, Minnesota",327,325,0,1,0,2,1,327,1,326,325,2
"Buckman city, Morrison County, Minnesota",277,276,0,0,1,0,0,277,0,277,277,0
"Buckman township, Morrison County, Minnesota",710,704,0,0,0,0,6,710,19,691,710,0
"Buh township, Morrison County, Minnesota",464,456,0,0,0,0,8,464,8,456,464,0
"Culdrum township, Morrison County, Minnesota",519,474,0,5,0,0,45,519,45,474,514,5
"Cushing township, Morrison County, Minnesota",778,774,9,13,1,0,0,778,6,772,759,19
"Darling township, Morrison County, Minnesota",541,540,16,0,1,0,0,541,0,541,525,16
"Elmdale city, Morrison County, Minnesota",65,65,0,0,0,0,0,65,0,65,65,0
"Elmdale township, Morrison County, Minnesota",1000,991,0,0,0,0,9,1000,14,986,1000,0
"Flensburg city, Morrison County, Minnesota",241,239,0,7,2,0,0,241,0,241,234,7
"Genola city, Morrison County, Minnesota",72,72,0,0,0,0,0,72,0,72,72,0
"Granite township, Morrison County, Minnesota",519,515,4,0,0,0,0,519,4,515,519,0
"Green Prairie township, Morrison County, Minnesota",706,684,0,17,10,0,0,706,8,698,701,5
"Harding city, Morrison County, Minnesota",158,153,0,3,2,0,0,158,0,158,158,0
"Hillman city, Morrison County, Minnesota",39,39,0,0,0,0,0,39,0,39,39,0
"Hillman township, Morrison County, Minnesota",198,196,0,0,2,0,0,198,0,198,198,0
"Lakin township, Morrison County, Minnesota",409,405,3,3,2,0,1,409,6,403,404,5
"Lastrup city, Morrison County, Minnesota",181,181,0,0,0,0,0,181,0,181,181,0
"Leigh township, Morrison County, Minnesota",234,224,11,12,1,0,0,234,0,234,220,14
"Little Falls city, Morrison County, Minnesota",8648,8330,237,91,85,0,90,8648,91,8557,8463,185
"Little Falls township, Morrison County, Minnesota",1641,1605,0,5,33,0,0,1641,0,1641,1639,2
"Morrill township, Morrison County, Minnesota",762,755,0,7,0,0,0,762,3,759,762,0
"Motley city, Morrison County, Minnesota",600,594,4,6,0,0,0,600,38,562,596,4
"Motley township, Morrison County, Minnesota",221,221,0,0,0,0,0,221,0,221,221,0
"Mount Morris township, Morrison County, Minnesota",83,83,0,9,0,0,0,83,0,83,74,9
"Parker township, Morrison County, Minnesota",507,505,0,2,0,0,0,507,4,503,507,0
"Pierz city, Morrison County, Minnesota",1509,1500,0,26,10,0,0,1509,20,1489,1482,27
"Pierz township, Morrison County, Minnesota",604,597,4,1,4,0,0,604,0,604,602,2
"Pike Creek township, Morrison County, Minnesota",965,933,0,12,5,0,38,965,20,945,942,23
"Platte township, Morrison County, Minnesota",322,321,0,0,1,0,0,322,2,320,322,0
"Pulaski township, Morrison County, Minnesota",295,288,0,0,0,0,7,295,7,288,295,0
"Randall city, Morrison County, Minnesota",659,659,0,0,0,0,0,659,17,642,659,0
"Richardson township, Morrison County, Minnesota",470,470,0,0,1,0,0,470,0,470,469,1
"Ripley township, Morrison County, Minnesota",696,694,0,2,2,0,0,696,3,693,694,2
"Rosing township, Morrison County, Minnesota",127,127,0,0,4,0,0,127,0,127,123,4
"Royalton city, Morrison County, Minnesota",1206,1202,0,16,5,0,0,1206,49,1157,1189,17
"Scandia Valley township, Morrison County, Minnesota",1070,1066,0,4,0,0,0,1070,17,1053,1070,0
"Sobieski city, Morrison County, Minnesota",186,186,1,2,0,0,0,186,0,186,183,3
"Swan River township, Morrison County, Minnesota",629,616,13,0,0,0,0,629,15,614,629,0
"Swanville city, Morrison County, Minnesota",376,376,0,0,0,0,0,376,22,354,376,0
"Swanville township, Morrison County, Minnesota",469,468,0,1,0,0,1,469,1,468,468,1
"Two Rivers township, Morrison County, Minnesota",714,710,0,0,8,0,0,714,15,699,710,4
"Upsala city, Morrison County, Minnesota",536,504,0,3,0,0,32,536,53,483,533,3
"Adams city, Mower County, Minnesota",730,714,14,0,4,0,0,730,9,721,728,2
"Adams township, Mower County, Minnesota",410,410,0,0,0,0,0,410,21,389,410,0
"Austin city, Mower County, Minnesota",24882,22081,1527,162,1125,154,584,24882,3939,20943,24155,727
"Austin township, Mower County, Minnesota",959,952,2,0,7,0,2,959,2,957,955,4
"Bennington township, Mower County, Minnesota",128,128,0,2,0,0,0,128,0,128,126,2
"Brownsdale city, Mower County, Minnesota",649,643,0,0,6,0,0,649,10,639,649,0
"Clayton township, Mower County, Minnesota",173,172,0,0,1,0,0,173,0,173,173,0
"Dexter city, Mower County, Minnesota",314,306,7,0,1,0,0,314,0,314,314,0
"Dexter township, Mower County, Minnesota",280,276,0,2,3,0,0,280,5,275,279,1
"Elkton city, Mower County, Minnesota",90,85,0,0,0,0,5,90,5,85,90,0
"Frankford township, Mower County, Minnesota",401,401,0,0,0,0,0,401,0,401,401,0
"Grand Meadow city, Mower County, Minnesota",1132,1102,39,4,7,0,0,1132,25,1107,1112,20
"Grand Meadow township, Mower County, Minnesota",249,247,0,5,0,0,0,249,0,249,246,3
"Lansing township, Mower County, Minnesota",1117,1003,0,1,99,0,14,1117,41,1076,1117,0
"Le Roy city, Mower County, Minnesota",983,958,74,21,4,0,0,983,22,961,909,74
"Le Roy township, Mower County, Minnesota",261,256,0,1,5,0,0,261,14,247,260,1
"Lodi township, Mower County, Minnesota",226,226,0,0,0,0,0,226,1,225,226,0
"Lyle city, Mower County, Minnesota",502,497,0,33,3,0,0,502,0,502,471,31
"Lyle township, Mower County, Minnesota",299,299,8,2,0,0,0,299,0,299,289,10
"Mapleview city, Mower County, Minnesota",139,139,0,0,0,0,0,139,10,129,139,0
"Marshall township, Mower County, Minnesota",402,391,2,0,11,0,0,402,0,402,400,2
"Nevada township, Mower County, Minnesota",453,453,0,0,0,0,0,453,8,445,453,0
"Pleasant Valley township, Mower County, Minnesota",277,270,4,1,0,4,2,277,2,275,273,4
"Racine city, Mower County, Minnesota",430,429,5,0,0,0,1,430,3,427,425,5
"Racine township, Mower County, Minnesota",585,563,22,0,0,0,0,585,0,585,585,0
"Red Rock township, Mower County, Minnesota",750,750,8,3,5,2,0,750,0,750,735,15
"Rose Creek city, Mower County, Minnesota",435,432,0,2,3,0,0,435,32,403,433,2
"Sargeant city, Mower County, Minnesota",50,50,0,0,0,0,0,50,0,50,50,0
"Sargeant township, Mower County, Minnesota",361,354,0,0,7,0,0,361,5,356,361,0
"Taopi city, Mower County, Minnesota",51,51,0,0,0,0,0,51,0,51,51,0
"Udolpho township, Mower County, Minnesota",475,470,5,0,0,0,0,475,2,473,475,0
"Waltham city, Mower County, Minnesota",136,135,0,1,0,0,0,136,16,120,136,0
"Waltham township, Mower County, Minnesota",403,398,2,0,7,0,0,403,0,403,399,4
"Windom township, Mower County, Minnesota",654,607,0,0,0,0,47,654,162,492,654,0
"Avoca city, Murray County, Minnesota",101,101,0,0,0,0,0,101,1,100,101,0
"Belfast township, Murray County, Minnesota",223,223,0,0,0,0,0,223,0,223,223,0
"Bondin township, Murray County, Minnesota",306,306,0,0,0,0,0,306,5,301,306,0
"Cameron township, Murray County, Minnesota",133,133,0,0,0,0,0,133,1,132,133,0
"Chanarambie township, Murray County, Minnesota",243,218,29,3,5,0,0,243,9,234,231,12
"Chandler city, Murray County, Minnesota",325,281,0,2,28,0,16,325,85,240,323,2
"Currie city, Murray County, Minnesota",215,215,0,0,0,0,0,215,3,212,215,0
"Des Moines River township, Murray County, Minnesota",108,108,0,0,0,0,0,108,0,108,108,0
"Dovray city, Murray County, Minnesota",60,60,0,0,0,0,0,60,0,60,60,0
"Dovray township, Murray County, Minnesota",136,136,0,0,0,0,0,136,0,136,136,0
"Ellsborough township, Murray County, Minnesota",163,158,0,0,0,0,5,163,5,158,163,0
"Fenton township, Murray County, Minnesota",132,132,0,0,0,0,0,132,0,132,132,0
"Fulda city, Murray County, Minnesota",1291,1223,18,29,52,0,0,1291,101,1190,1260,31
"Hadley city, Murray County, Minnesota",53,53,0,0,0,0,0,53,0,53,53,0
"Holly township, Murray County, Minnesota",92,92,3,0,0,0,0,92,0,92,89,3
"Iona city, Murray County, Minnesota",135,133,0,0,2,0,0,135,2,133,135,0
"Iona township, Murray County, Minnesota",118,118,0,0,0,0,0,118,0,118,118,0
"Lake Sarah township, Murray County, Minnesota",369,360,5,8,0,0,0,369,4,365,365,4
"Lake Wilson city, Murray County, Minnesota",255,255,0,0,0,0,0,255,1,254,255,0
"Leeds township, Murray County, Minnesota",243,243,0,0,5,0,0,243,33,210,238,5
"Lime Lake township, Murray County, Minnesota",207,207,0,0,0,0,0,207,6,201,207,0
"Lowville township, Murray County, Minnesota",192,192,0,0,0,0,0,192,1,191,192,0
"Mason township, Murray County, Minnesota",321,321,0,3,0,0,0,321,0,321,318,3
"Moulton township, Murray County, Minnesota",153,149,0,0,4,0,0,153,0,153,153,0
"Murray township, Murray County, Minnesota",144,144,0,0,3,0,0,144,0,144,141,3
"Shetek township, Murray County, Minnesota",294,284,8,0,0,0,2,294,10,284,294,0
"Skandia township, Murray County, Minnesota",133,133,0,0,0,0,0,133,0,133,133,0
"Slayton city, Murray County, Minnesota",1979,1949,20,0,3,0,7,1979,34,1945,1979,0
"Slayton township, Murray County, Minnesota",270,270,0,0,0,0,0,270,0,270,270,0
"Belgrade township, Nicollet County, Minnesota",1030,1027,0,0,6,0,0,1030,5,1025,1027,3
"Bernadotte township, Nicollet County, Minnesota",248,248,0,0,0,0,0,248,11,237,248,0
"Brighton township, Nicollet County, Minnesota",160,160,0,0,0,0,0,160,8,152,160,0
"Courtland city, Nicollet County, Minnesota",657,657,0,0,0,0,0,657,12,645,657,0
"Courtland township, Nicollet County, Minnesota",582,582,0,0,0,0,0,582,9,573,582,0
"Granby township, Nicollet County, Minnesota",204,204,0,0,0,0,0,204,0,204,204,0
"Lafayette city, Nicollet County, Minnesota",450,450,16,1,2,0,0,450,0,450,431,19
"Lafayette township, Nicollet County, Minnesota",695,695,0,0,0,0,0,695,0,695,695,0
"Lake Prairie township, Nicollet County, Minnesota",767,752,13,0,15,0,0,767,50,717,754,13
"Le Sueur city, Nicollet County, Minnesota",0,0,0,0,0,0,0,0,0,0,0,0
"Mankato city, Nicollet County, Minnesota",0,0,0,0,0,0,0,0,0,0,0,0
"New Sweden township, Nicollet County, Minnesota",208,207,1,0,1,0,0,208,4,204,207,1
"Nicollet city, Nicollet County, Minnesota",1151,1140,0,11,0,0,11,1151,113,1038,1140,11
"Nicollet township, Nicollet County, Minnesota",575,574,1,1,0,0,1,575,1,574,573,2
"North Mankato city, Nicollet County, Minnesota",13583,12520,772,31,244,0,166,13583,327,13256,13433,150
"Oshawa township, Nicollet County, Minnesota",731,709,4,0,8,0,33,731,43,688,708,23
"Ridgely township, Nicollet County, Minnesota",79,79,0,0,0,0,0,79,0,79,79,0
"St. Peter city, Nicollet County, Minnesota",11682,10850,391,181,425,0,121,11682,844,10838,11406,276
"Traverse township, Nicollet County, Minnesota",268,264,0,2,0,0,2,268,2,266,268,0
"West Newton township, Nicollet County, Minnesota",407,407,1,0,1,0,0,407,2,405,405,2
"Adrian city, Nobles County, Minnesota",1198,1121,19,24,56,0,16,1198,35,1163,1160,38
"Bigelow city, Nobles County, Minnesota",225,221,8,0,0,0,2,225,90,135,219,6
"Bigelow township, Nobles County, Minnesota",375,348,0,0,0,0,27,375,27,348,375,0
"Bloom township, Nobles County, Minnesota",125,125,0,0,0,0,0,125,0,125,125,0
"Brewster city, Nobles County, Minnesota",515,484,7,0,9,0,20,515,62,453,510,5
"Dewald township, Nobles County, Minnesota",255,250,0,5,0,0,0,255,22,233,255,0
"Dundee city, Nobles County, Minnesota",83,83,0,0,0,0,0,83,0,83,83,0
"Elk township, Nobles County, Minnesota",259,259,0,0,0,0,0,259,13,246,259,0
"Ellsworth city, Nobles County, Minnesota",512,496,49,0,0,0,4,512,4,508,475,37
"Graham Lakes township, Nobles County, Minnesota",204,204,0,0,0,0,0,204,0,204,204,0
"Grand Prairie township, Nobles County, Minnesota",238,234,0,4,0,0,0,238,3,235,238,0
"Hersey township, Nobles County, Minnesota",183,183,0,0,0,0,0,183,2,181,183,0
"Indian Lake township, Nobles County, Minnesota",237,237,2,0,0,0,0,237,0,237,235,2
"Kinbrae city, Nobles County, Minnesota",4,4,0,0,0,0,0,4,0,4,4,0
"Larkin township, Nobles County, Minnesota",188,184,4,0,2,0,1,188,0,188,185,3
"Leota township, Nobles County, Minnesota",379,372,0,0,7,0,0,379,0,379,379,0
"Lismore city, Nobles County, Minnesota",231,228,3,0,0,0,0,231,60,171,231,0
"Lismore township, Nobles County, Minnesota",184,182,0,0,0,0,2,184,17,167,184,0
"Little Rock township, Nobles County, Minnesota",183,176,0,0,0,5,2,183,2,181,183,0
"Lorain township, Nobles County, Minnesota",337,335,0,0,0,0,2,337,11,326,337,0
"Olney township, Nobles County, Minnesota",179,177,2,0,0,0,0,179,0,179,179,0
"Ransom township, Nobles County, Minnesota",171,157,0,13,1,0,0,171,0,171,171,0
"Round Lake city, Nobles County, Minnesota",439,422,0,10,14,0,2,439,13,426,430,9
"Rushmore city, Nobles County, Minnesota",320,304,6,0,4,2,6,320,16,304,318,2
"Seward township, Nobles County, Minnesota",175,172,5,0,0,0,0,175,7,168,173,2
"Summit Lake township, Nobles County, Minnesota",427,424,0,0,0,9,3,427,25,402,418,9
"Westside township, Nobles County, Minnesota",204,195,9,5,0,0,0,204,0,204,199,5
"Wilmont city, Nobles County, Minnesota",415,397,0,6,12,0,0,415,30,385,415,0
"Wilmont township, Nobles County, Minnesota",135,135,0,0,0,0,0,135,0,135,135,0
"Worthington city, Nobles County, Minnesota",13142,8979,945,100,1402,5,1956,13142,5418,7724,12897,245
"Worthington township, Nobles County, Minnesota",332,326,0,0,3,1,4,332,6,326,330,2
"Ada city, Norman County, Minnesota",1795,1644,20,92,6,0,73,1795,157,1638,1755,40
"Anthony township, Norman County, Minnesota",82,82,0,0,0,0,0,82,11,71,82,0
"Bear Park township, Norman County, Minnesota",153,147,2,0,6,0,0,153,0,153,151,2
"Borup city, Norman County, Minnesota",76,73,0,6,3,0,0,76,21,55,70,6
"Flom township, Norman County, Minnesota",193,188,0,22,0,0,0,193,0,193,176,17
"Fossum township, Norman County, Minnesota",122,112,0,7,6,0,0,122,0,122,119,3
"Gary city, Norman County, Minnesota",305,274,24,0,7,0,0,305,0,305,305,0
"Good Hope township, Norman County, Minnesota",47,47,0,0,0,0,0,47,0,47,47,0
"Green Meadow township, Norman County, Minnesota",70,70,0,0,0,0,0,70,0,70,70,0
"Halstad city, Norman County, Minnesota",636,604,6,29,4,4,7,636,58,578,618,18
"Halstad township, Norman County, Minnesota",89,89,0,0,0,0,0,89,0,89,89,0
"Hegne township, Norman County, Minnesota",37,37,0,5,0,0,0,37,0,37,32,5
"Hendrum city, Norman County, Minnesota",347,342,0,8,8,0,0,347,8,339,336,11
"Hendrum township, Norman County, Minnesota",86,83,0,0,3,0,0,86,2,84,86,0
"Home Lake township, Norman County, Minnesota",95,95,0,0,0,0,0,95,0,95,95,0
"Lake Ida township, Norman County, Minnesota",125,125,0,2,0,0,0,125,0,125,123,2
"Lee township, Norman County, Minnesota",107,107,0,4,0,0,0,107,0,107,103,4
"Lockhart township, Norman County, Minnesota",53,53,0,0,0,0,2,53,0,53,51,2
"McDonaldsville township, Norman County, Minnesota",181,177,4,0,0,0,0,181,0,181,181,0
"Mary township, Norman County, Minnesota",75,71,0,4,0,0,0,75,0,75,75,0
"Perley city, Norman County, Minnesota",49,49,0,0,0,0,0,49,0,49,49,0
"Pleasant View township, Norman County, Minnesota",99,99,0,17,4,0,0,99,9,90,78,21
"Rockwell township, Norman County, Minnesota",78,78,0,0,0,0,0,78,0,78,78,0
"Shelly city, Norman County, Minnesota",140,132,0,8,0,0,0,140,36,104,140,0
"Shelly township, Norman County, Minnesota",114,114,0,0,0,0,0,114,9,105,114,0
"Spring Creek township, Norman County, Minnesota",74,62,0,0,12,12,0,74,12,62,62,12
"Strand township, Norman County, Minnesota",85,73,0,12,0,0,0,85,5,80,85,0
"Sundal township, Norman County, Minnesota",149,140,9,0,0,0,0,149,0,149,149,0
"Twin Valley city, Norman County, Minnesota",781,765,4,11,7,0,0,781,0,781,775,6
"Waukon township, Norman County, Minnesota",82,76,0,8,0,0,0,82,0,82,80,2
"Wild Rice township, Norman County, Minnesota",211,208,0,3,0,0,0,211,0,211,211,0
"Winchester township, Norman County, Minnesota",53,53,0,0,0,0,0,53,0,53,53,0
"Byron city, Olmsted County, Minnesota",5272,5218,31,39,19,0,32,5272,23,5249,5205,67
"Cascade township, Olmsted County, Minnesota",2869,2716,10,0,139,0,18,2869,42,2827,2855,14
"Chatfield city, Olmsted County, Minnesota",1241,1233,5,9,0,0,8,1241,48,1193,1232,9
"Dover city, Olmsted County, Minnesota",819,808,3,2,3,0,8,819,27,792,814,5
"Dover township, Olmsted County, Minnesota",370,356,2,1,0,0,12,370,12,358,369,1
"Elmira township, Olmsted County, Minnesota",386,383,0,0,3,0,0,386,0,386,386,0
"Eyota city, Olmsted County, Minnesota",1850,1799,18,4,33,0,24,1850,46,1804,1822,28
"Eyota township, Olmsted County, Minnesota",413,392,4,0,3,0,14,413,16,397,413,0
"Farmington township, Olmsted County, Minnesota",421,419,0,0,2,0,0,421,5,416,421,0
"Haverhill township, Olmsted County, Minnesota",1501,1404,24,5,91,0,13,1501,5,1496,1468,33
"High Forest township, Olmsted County, Minnesota",1229,1218,3,0,5,0,3,1229,10,1219,1229,0
"Kalmar township, Olmsted County, Minnesota",1230,1226,0,0,4,0,0,1230,77,1153,1230,0
"Marion township, Olmsted County, Minnesota",3799,3689,72,6,57,0,7,3799,62,3737,3767,32
"New Haven township, Olmsted County, Minnesota",1084,1081,0,3,12,0,3,1084,8,1076,1069,15
"Orion township, Olmsted County, Minnesota",699,699,0,6,11,0,0,699,11,688,682,17
"Oronoco city, Olmsted County, Minnesota",1607,1482,33,0,80,0,14,1607,12,1595,1605,2
"Oronoco township, Olmsted County, Minnesota",2047,1940,14,26,85,0,8,2047,34,2013,2021,26
"Pine Island city, Olmsted County, Minnesota",835,835,0,0,0,0,0,835,12,823,835,0
"Pleasant Grove township, Olmsted County, Minnesota",750,750,3,0,0,0,0,750,8,742,747,3
"Quincy township, Olmsted County, Minnesota",415,411,2,0,2,0,0,415,0,415,415,0
"Rochester city, Olmsted County, Minnesota",112683,93977,9751,854,9939,50,1629,112683,6520,106163,109342,3341
"Rochester township, Olmsted County, Minnesota",1624,1505,31,2,132,0,0,1624,40,1584,1578,46
"Rock Dell township, Olmsted County, Minnesota",624,621,3,0,0,0,0,624,0,624,624,0
"Salem township, Olmsted County, Minnesota",1290,1279,14,0,0,0,0,1290,23,1267,1287,3
"Stewartville city, Olmsted County, Minnesota",6115,6022,122,43,10,0,130,6115,201,5914,5903,212
"Viola township, Olmsted County, Minnesota",512,500,10,0,8,0,0,512,0,512,506,6
"Aastad township, Otter Tail County, Minnesota",150,150,0,0,0,0,0,150,0,150,150,0
"Amor township, Otter Tail County, Minnesota",520,503,21,18,4,0,0,520,1,519,502,18
"Aurdal township, Otter Tail County, Minnesota",1748,1712,18,3,5,4,20,1748,24,1724,1734,14
"Battle Lake city, Otter Tail County, Minnesota",735,727,12,9,0,0,0,735,2,733,722,13
"Blowers township, Otter Tail County, Minnesota",335,334,1,0,0,0,0,335,2,333,335,0
"Bluffton city, Otter Tail County, Minnesota",155,155,0,0,1,0,0,155,0,155,154,1
"Bluffton township, Otter Tail County, Minnesota",479,479,0,1,0,0,0,479,26,453,478,1
"Buse township, Otter Tail County, Minnesota",476,462,10,1,0,0,6,476,11,465,473,3
"Butler township, Otter Tail County, Minnesota",231,229,0,7,2,0,0,231,7,224,224,7
"Candor township, Otter Tail County, Minnesota",547,539,0,37,2,0,4,547,9,538,512,35
"Carlisle township, Otter Tail County, Minnesota",124,124,0,0,0,0,0,124,2,122,124,0
"Clitherall city, Otter Tail County, Minnesota",97,95,0,0,0,2,0,97,2,95,97,0
"Clitherall township, Otter Tail County, Minnesota",510,510,0,5,0,0,0,510,0,510,505,5
"Compton township, Otter Tail County, Minnesota",909,909,0,0,0,0,0,909,0,909,909,0
"Corliss township, Otter Tail County, Minnesota",541,537,0,2,4,0,0,541,0,541,539,2
"Dalton city, Otter Tail County, Minnesota",255,249,8,0,0,0,0,255,0,255,253,2
"Dane Prairie township, Otter Tail County, Minnesota",752,736,10,0,5,0,8,752,17,735,745,7
"Dead Lake township, Otter Tail County, Minnesota",554,535,13,0,0,0,6,554,6,548,554,0
"Deer Creek city, Otter Tail County, Minnesota",239,239,19,12,0,0,0,239,0,239,208,31
"Deer Creek township, Otter Tail County, Minnesota",440,440,0,0,0,0,0,440,0,440,440,0
"Dent city, Otter Tail County, Minnesota",178,177,0,3,2,0,5,178,0,178,169,9
"Dora township, Otter Tail County, Minnesota",748,735,0,12,3,0,0,748,6,742,746,2
"Dunn township, Otter Tail County, Minnesota",765,759,0,3,6,0,0,765,10,755,762,3
"Eagle Lake township, Otter Tail County, Minnesota",384,382,0,20,2,0,0,384,2,382,364,20
"Eastern township, Otter Tail County, Minnesota",149,149,0,0,0,0,0,149,2,147,149,0
"Edna township, Otter Tail County, Minnesota",864,856,5,5,4,0,0,864,8,856,858,6
"Effington township, Otter Tail County, Minnesota",195,195,0,0,0,0,0,195,0,195,195,0
"Elizabeth city, Otter Tail County, Minnesota",160,156,0,0,0,4,0,160,0,160,160,0
"Elizabeth township, Otter Tail County, Minnesota",908,887,11,16,0,0,10,908,10,898,892,16
"Elmo township, Otter Tail County, Minnesota",312,308,8,0,0,0,0,312,0,312,308,4
"Erhard city, Otter Tail County, Minnesota",115,112,0,9,0,0,0,115,1,114,109,6
"Erhards Grove township, Otter Tail County, Minnesota",478,468,9,5,0,0,0,478,10,468,474,4
"Everts township, Otter Tail County, Minnesota",714,712,8,7,0,0,2,714,3,711,699,15
"Fergus Falls city, Otter Tail County, Minnesota",13606,13057,410,88,166,0,4,13606,461,13145,13487,119
"Fergus Falls township, Otter Tail County, Minnesota",927,927,0,0,0,0,0,927,6,921,927,0
"Folden township, Otter Tail County, Minnesota",248,248,0,4,0,0,0,248,0,248,244,4
"Friberg township, Otter Tail County, Minnesota",843,834,1,8,0,0,3,843,5,838,840,3
"Girard township, Otter Tail County, Minnesota",580,570,8,2,0,0,0,580,1,579,580,0
"Gorman township, Otter Tail County, Minnesota",429,428,3,2,0,0,0,429,0,429,425,4
"Henning city, Otter Tail County, Minnesota",923,903,13,15,9,0,2,923,11,912,904,19
"Henning township, Otter Tail County, Minnesota",273,273,0,0,0,0,0,273,1,272,273,0
"Hobart township, Otter Tail County, Minnesota",749,734,10,15,0,0,7,749,12,737,732,17
"Homestead township, Otter Tail County, Minnesota",430,430,0,3,3,0,0,430,2,428,427,3
"Inman township, Otter Tail County, Minnesota",293,292,1,2,0,1,0,293,1,292,291,2
"Leaf Lake township, Otter Tail County, Minnesota",597,593,4,0,0,0,0,597,0,597,597,0
"Leaf Mountain township, Otter Tail County, Minnesota",294,294,0,0,0,0,0,294,0,294,294,0
"Lida township, Otter Tail County, Minnesota",646,645,0,0,9,9,0,646,15,631,637,9
"Maine township, Otter Tail County, Minnesota",661,620,11,23,0,0,7,661,0,661,661,0
"Maplewood township, Otter Tail County, Minnesota",303,298,1,0,2,0,4,303,5,298,301,2
"Newton township, Otter Tail County, Minnesota",834,834,0,11,0,0,0,834,2,832,823,11
"New York Mills city, Otter Tail County, Minnesota",1367,1316,20,28,4,0,5,1367,13,1354,1361,6
"Nidaros township, Otter Tail County, Minnesota",289,289,2,2,1,0,0,289,0,289,284,5
"Norwegian Grove township, Otter Tail County, Minnesota",251,249,0,0,2,0,0,251,0,251,251,0
"Oak Valley township, Otter Tail County, Minnesota",404,404,0,0,0,0,0,404,4,400,404,0
"Orwell township, Otter Tail County, Minnesota",93,93,0,10,0,0,0,93,0,93,83,10
"Oscar township, Otter Tail County, Minnesota",103,103,0,0,0,0,0,103,8,95,103,0
"Ottertail city, Otter Tail County, Minnesota",501,447,0,9,1,0,56,501,56,445,489,12
"Otter Tail township, Otter Tail County, Minnesota",613,605,6,5,8,0,0,613,4,609,602,11
"Otto township, Otter Tail County, Minnesota",445,445,0,0,0,0,0,445,11,434,445,0
"Paddock township, Otter Tail County, Minnesota",307,306,1,0,0,0,0,307,0,307,307,0
"Parkers Prairie city, Otter Tail County, Minnesota",1025,1023,3,4,2,0,0,1025,0,1025,1018,7
"Parkers Prairie township, Otter Tail County, Minnesota",427,427,0,3,0,0,0,427,0,427,424,3
"Pelican township, Otter Tail County, Minnesota",529,520,0,7,1,0,1,529,12,517,529,0
"Pelican Rapids city, Otter Tail County, Minnesota",2659,1909,326,113,183,0,251,2659,672,1987,2546,113
"Perham city, Otter Tail County, Minnesota",3261,3108,27,60,43,0,94,3261,333,2928,3190,71
"Perham township, Otter Tail County, Minnesota",857,852,9,0,0,0,2,857,14,843,851,6
"Pine Lake township, Otter Tail County, Minnesota",578,576,2,0,0,0,0,578,4,574,578,0
"Richville city, Otter Tail County, Minnesota",100,100,0,0,0,0,0,100,0,100,100,0
"Rothsay city, Otter Tail County, Minnesota",226,221,4,1,0,0,0,226,0,226,226,0
"Rush Lake township, Otter Tail County, Minnesota",922,919,0,0,3,3,0,922,0,922,919,3
"St. Olaf township, Otter Tail County, Minnesota",430,428,2,0,2,0,0,430,0,430,428,2
"Scambler township, Otter Tail County, Minnesota",508,505,2,0,0,0,3,508,3,505,506,2
"Star Lake township, Otter Tail County, Minnesota",365,363,2,0,1,0,0,365,0,365,364,1
"Sverdrup township, Otter Tail County, Minnesota",658,615,15,2,8,0,26,658,31,627,650,8
"Tordenskjold township, Otter Tail County, Minnesota",480,480,3,7,0,4,0,480,0,480,466,14
"Trondhjem township, Otter Tail County, Minnesota",158,157,0,4,0,0,0,158,14,144,155,3
"Tumuli township, Otter Tail County, Minnesota",529,527,0,2,0,0,2,529,2,527,527,2
"Underwood city, Otter Tail County, Minnesota",418,411,7,59,0,0,0,418,1,417,359,59
"Urbank city, Otter Tail County, Minnesota",78,78,0,0,0,0,0,78,0,78,78,0
"Vergas city, Otter Tail County, Minnesota",377,377,0,18,0,0,0,377,2,375,359,18
"Vining city, Otter Tail County, Minnesota",45,44,9,0,9,1,0,45,2,43,36,9
"Wadena city, Otter Tail County, Minnesota",47,47,0,0,0,0,0,47,0,47,47,0
"Western township, Otter Tail County, Minnesota",104,104,0,0,0,0,0,104,0,104,104,0
"Woodside township, Otter Tail County, Minnesota",233,232,0,23,0,0,0,233,1,232,211,22
"Black River township, Pennington County, Minnesota",39,39,0,0,0,0,0,39,0,39,39,0
"Bray township, Pennington County, Minnesota",27,27,0,0,0,0,0,27,0,27,27,0
"Cloverleaf township, Pennington County, Minnesota",53,53,0,0,0,0,0,53,0,53,53,0
"Deer Park township, Pennington County, Minnesota",136,136,0,0,0,0,0,136,26,110,136,0
"Goodridge city, Pennington County, Minnesota",151,134,17,6,0,0,0,151,22,129,145,6
"Goodridge township, Pennington County, Minnesota",39,39,0,0,0,0,0,39,9,30,39,0
"Hickory township, Pennington County, Minnesota",95,95,0,0,0,0,0,95,0,95,95,0
"Highlanding township, Pennington County, Minnesota",193,174,6,21,0,0,0,193,11,182,185,8
"Kratka township, Pennington County, Minnesota",136,122,0,0,2,0,12,136,12,124,136,0
"Mayfield township, Pennington County, Minnesota",55,54,0,1,0,0,0,55,0,55,55,0
"Norden township, Pennington County, Minnesota",382,381,0,0,0,1,0,382,0,382,382,0
"North township, Pennington County, Minnesota",736,694,17,12,16,0,0,736,0,736,733,3
"Numedal township, Pennington County, Minnesota",147,147,0,0,0,0,0,147,10,137,147,0
"Polk Centre township, Pennington County, Minnesota",61,61,0,0,0,0,0,61,0,61,61,0
"Reiner township, Pennington County, Minnesota",91,88,4,3,0,0,0,91,0,91,87,4
"River Falls township, Pennington County, Minnesota",219,217,0,0,1,1,0,219,0,219,219,0
"Rocksbury township, Pennington County, Minnesota",1208,1171,15,37,6,0,0,1208,18,1190,1187,21
"St. Hilaire city, Pennington County, Minnesota",242,235,0,1,3,0,3,242,8,234,242,0
"Sanders township, Pennington County, Minnesota",347,345,0,0,0,0,8,347,8,339,341,6
"Silverton township, Pennington County, Minnesota",184,184,0,0,0,0,2,184,2,182,182,2
"Smiley township, Pennington County, Minnesota",715,659,20,22,28,6,27,715,36,679,680,35
"Star township, Pennington County, Minnesota",91,89,0,2,0,0,0,91,0,91,91,0
"Thief River Falls city, Pennington County, Minnesota",8769,8343,224,233,122,6,0,8769,334,8435,8625,144
"Wyandotte township, Pennington County, Minnesota",81,81,0,0,0,0,0,81,0,81,81,0
"Arlone township, Pine County, Minnesota",419,415,0,15,0,0,0,419,41,378,408,11
"Arna township, Pine County, Minnesota",47,42,0,5,0,0,0,47,0,47,47,0
"Askov city, Pine County, Minnesota",352,352,0,6,0,0,0,352,3,349,346,6
"Barry township, Pine County, Minnesota",559,490,11,86,0,0,2,559,69,490,540,19
"Birch Creek township, Pine County, Minnesota",225,225,0,4,0,0,0,225,1,224,221,4
"Bremen township, Pine County, Minnesota",199,198,1,4,0,0,0,199,1,198,195,4
"Brook Park city, Pine County, Minnesota",118,118,0,0,0,0,0,118,0,118,118,0
"Brook Park township, Pine County, Minnesota",500,492,0,10,0,0,6,500,6,494,492,8
"Bruno city, Pine County, Minnesota",85,85,0,3,0,0,0,85,0,85,82,3
"Bruno township, Pine County, Minnesota",176,176,0,0,0,0,0,176,20,156,176,0
"Chengwatana township, Pine County, Minnesota",988,984,2,3,20,0,0,988,3,985,967,21
"Clover township, Pine County, Minnesota",460,448,5,11,0,0,3,460,10,450,453,7
"Crosby township, Pine County, Minnesota",68,68,0,0,0,0,0,68,0,68,68,0
"Danforth township, Pine County, Minnesota",63,63,0,0,0,0,0,63,0,63,63,0
"Dell Grove township, Pine County, Minnesota",548,537,11,3,0,0,0,548,0,548,545,3
"Denham city, Pine County, Minnesota",38,38,0,0,0,0,0,38,0,38,38,0
"Finlayson city, Pine County, Minnesota",334,327,0,0,3,0,4,334,7,327,334,0
"Finlayson township, Pine County, Minnesota",451,441,15,7,2,0,0,451,0,451,437,14
"Fleming township, Pine County, Minnesota",102,102,0,0,0,0,2,102,2,100,100,2
"Henriette city, Pine County, Minnesota",97,94,0,0,3,0,0,97,0,97,97,0
"Hinckley city, Pine County, Minnesota",1519,1302,121,280,7,38,0,1519,38,1481,1318,201
"Hinckley township, Pine County, Minnesota",965,941,3,33,0,0,3,965,26,939,950,15
"Kerrick city, Pine County, Minnesota",66,66,0,0,0,0,0,66,0,66,66,0
"Kerrick township, Pine County, Minnesota",364,353,0,3,4,0,4,364,4,360,364,0
"Kettle River township, Pine County, Minnesota",575,572,0,14,0,0,0,575,4,571,564,11
"Mission Creek township, Pine County, Minnesota",633,619,0,46,18,0,0,633,18,615,583,50
"Munch township, Pine County, Minnesota",335,314,7,14,0,0,0,335,0,335,335,0
"New Dosey township, Pine County, Minnesota",46,44,0,2,0,0,0,46,0,46,46,0
"Nickerson township, Pine County, Minnesota",151,151,1,2,0,0,0,151,0,151,148,3
"Norman township, Pine County, Minnesota",253,233,0,20,0,0,0,253,8,245,253,0
"Ogema township, Pine County, Minnesota",300,173,0,130,0,0,6,300,10,290,291,9
"Park township, Pine County, Minnesota",15,15,0,0,0,0,0,15,0,15,15,0
"Partridge township, Pine County, Minnesota",605,583,10,22,0,0,0,605,7,598,595,10
"Pine City city, Pine County, Minnesota",3059,2923,106,16,20,8,73,3059,79,2980,2984,75
"Pine City township, Pine County, Minnesota",1330,1305,32,9,19,0,3,1330,42,1288,1292,38
"Pine Lake township, Pine County, Minnesota",548,548,0,7,9,0,0,548,9,539,532,16
"Pokegama township, Pine County, Minnesota",2654,2618,6,56,24,0,0,2654,49,2605,2604,50
"Rock Creek city, Pine County, Minnesota",1791,1752,0,13,43,5,2,1791,12,1779,1767,24
"Royalton township, Pine County, Minnesota",1241,1183,42,1,0,0,21,1241,51,1190,1235,6
"Rutledge city, Pine County, Minnesota",180,179,0,0,1,0,0,180,3,177,180,0
"Sandstone city, Pine County, Minnesota",2702,2106,394,198,29,16,105,2702,233,2469,2602,100
"Sandstone township, Pine County, Minnesota",1034,947,30,125,25,0,0,1034,16,1018,947,87
"Sturgeon Lake city, Pine County, Minnesota",407,405,0,8,0,0,0,407,0,407,401,6
"Sturgeon Lake township, Pine County, Minnesota",487,416,55,20,7,0,9,487,8,479,475,12
"Willow River city, Pine County, Minnesota",443,440,0,4,0,0,3,443,15,428,439,4
"Wilma township, Pine County, Minnesota",65,40,22,3,0,0,0,65,0,65,65,0
"Windemere township, Pine County, Minnesota",1460,1439,0,17,24,0,0,1460,19,1441,1440,20
"Aetna township, Pipestone County, Minnesota",221,221,0,0,0,0,0,221,0,221,221,0
"Altona township, Pipestone County, Minnesota",96,96,0,0,0,0,0,96,0,96,96,0
"Burke township, Pipestone County, Minnesota",241,241,0,0,0,0,0,241,7,234,241,0
"Eden township, Pipestone County, Minnesota",244,244,0,0,0,0,0,244,0,244,244,0
"Edgerton city, Pipestone County, Minnesota",1194,1178,12,25,0,0,0,1194,52,1142,1173,21
"Elmer township, Pipestone County, Minnesota",235,235,0,0,0,0,0,235,0,235,235,0
"Fountain Prairie township, Pipestone County, Minnesota",180,180,0,0,0,0,0,180,0,180,180,0
"Grange township, Pipestone County, Minnesota",192,188,1,2,0,0,2,192,2,190,191,1
"Gray township, Pipestone County, Minnesota",199,199,0,0,0,0,0,199,0,199,199,0
"Hatfield city, Pipestone County, Minnesota",33,30,0,3,0,0,0,33,2,31,33,0
"Holland city, Pipestone County, Minnesota",169,158,1,13,0,0,0,169,2,167,166,3
"Ihlen city, Pipestone County, Minnesota",46,46,0,0,0,0,0,46,2,44,46,0
"Jasper city, Pipestone County, Minnesota",579,572,10,4,10,7,2,579,25,554,553,26
"Osborne township, Pipestone County, Minnesota",322,320,0,2,0,0,0,322,2,320,322,0
"Pipestone city, Pipestone County, Minnesota",4102,3723,165,194,87,0,127,4102,399,3703,3938,164
"Rock township, Pipestone County, Minnesota",144,141,0,3,0,0,0,144,0,144,144,0
"Ruthton city, Pipestone County, Minnesota",293,281,2,24,0,0,10,293,48,245,269,24
"Sweet township, Pipestone County, Minnesota",287,285,2,6,0,0,0,287,0,287,281,6
"Trosky city, Pipestone County, Minnesota",94,94,0,0,0,0,0,94,0,94,94,0
"Troy township, Pipestone County, Minnesota",217,217,0,0,0,0,0,217,0,217,217,0
"Woodstock city, Pipestone County, Minnesota",141,122,0,19,0,0,0,141,0,141,141,0
"Andover township, Polk County, Minnesota",91,91,0,0,0,0,0,91,0,91,91,0
"Angus township, Polk County, Minnesota",45,45,0,0,0,0,0,45,0,45,45,0
"Badger township, Polk County, Minnesota",95,95,0,0,0,0,0,95,0,95,95,0
"Belgium township, Polk County, Minnesota",105,93,8,12,0,0,0,105,2,103,97,8
"Beltrami city, Polk County, Minnesota",102,102,0,0,0,0,0,102,0,102,102,0
"Brandsvold township, Polk County, Minnesota",293,288,9,8,0,0,0,293,0,293,281,12
"Brandt township, Polk County, Minnesota",79,79,0,0,0,0,0,79,0,79,79,0
"Brislet township, Polk County, Minnesota",26,26,0,0,0,0,0,26,0,26,26,0
"Bygland township, Polk County, Minnesota",254,254,0,0,0,0,0,254,0,254,254,0
"Chester township, Polk County, Minnesota",66,66,0,0,0,0,0,66,0,66,66,0
"Climax city, Polk County, Minnesota",291,278,1,5,4,5,0,291,7,284,289,2
"Columbia township, Polk County, Minnesota",358,348,2,16,7,0,0,358,3,355,347,11
"Crookston city, Polk County, Minnesota",7780,7223,203,126,143,0,225,7780,1095,6685,7640,140
"Crookston township, Polk County, Minnesota",442,437,0,5,0,0,2,442,3,439,440,2
"East Grand Forks city, Polk County, Minnesota",8614,8114,407,273,58,10,78,8614,436,8178,8291,323
"Eden township, Polk County, Minnesota",226,200,3,9,96,0,0,226,7,219,146,80
"Erskine city, Polk County, Minnesota",497,482,0,21,0,0,0,497,59,438,491,6
"Esther township, Polk County, Minnesota",213,185,0,0,0,0,28,213,28,185,213,0
"Euclid township, Polk County, Minnesota",132,132,0,0,0,0,1,132,4,128,131,1
"Fairfax township, Polk County, Minnesota",174,173,0,0,0,0,1,174,4,170,174,0
"Fanny township, Polk County, Minnesota",78,78,0,0,0,0,0,78,0,78,78,0
"Farley township, Polk County, Minnesota",46,46,0,0,0,0,0,46,0,46,46,0
"Fertile city, Polk County, Minnesota",1086,1055,1,32,0,0,0,1086,35,1051,1084,2
"Fisher city, Polk County, Minnesota",523,485,10,3,6,2,23,523,32,491,517,6
"Fisher township, Polk County, Minnesota",114,109,0,5,0,0,0,114,0,114,114,0
"Fosston city, Polk County, Minnesota",1613,1539,16,49,22,10,24,1613,65,1548,1566,47
"Garden township, Polk County, Minnesota",147,147,0,0,0,0,0,147,0,147,147,0
"Garfield township, Polk County, Minnesota",530,522,2,15,11,13,2,530,18,512,495,35
"Gentilly township, Polk County, Minnesota",214,214,3,0,0,0,0,214,7,207,211,3
"Godfrey township, Polk County, Minnesota",304,299,1,5,0,0,0,304,0,304,303,1
"Grand Forks township, Polk County, Minnesota",181,181,0,2,0,0,0,181,2,179,179,2
"Grove Park-Tilden township, Polk County, Minnesota",376,349,0,27,0,0,0,376,0,376,376,0
"Gully city, Polk County, Minnesota",60,60,0,0,0,0,0,60,0,60,60,0
"Gully township, Polk County, Minnesota",126,100,26,11,0,0,0,126,0,126,115,11
"Hammond township, Polk County, Minnesota",56,27,0,29,0,0,0,56,0,56,56,0
"Helgeland township, Polk County, Minnesota",78,78,0,0,0,0,0,78,0,78,78,0
"Higdem township, Polk County, Minnesota",76,76,0,0,0,0,0,76,9,67,76,0
"Hill River township, Polk County, Minnesota",86,85,0,4,0,0,0,86,4,82,83,3
"Hubbard township, Polk County, Minnesota",88,85,3,6,0,0,0,88,0,88,82,6
"Huntsville township, Polk County, Minnesota",456,453,0,3,0,0,0,456,17,439,456,0
"Johnson township, Polk County, Minnesota",55,55,0,0,0,0,0,55,0,55,55,0
"Kertsonville township, Polk County, Minnesota",62,60,0,2,0,0,0,62,0,62,62,0
"Keystone township, Polk County, Minnesota",51,51,0,0,0,0,0,51,0,51,51,0
"King township, Polk County, Minnesota",228,228,0,0,0,0,0,228,0,228,228,0
"Knute township, Polk County, Minnesota",578,571,0,14,0,0,0,578,0,578,571,7
"Lengby city, Polk County, Minnesota",93,93,0,0,0,0,0,93,0,93,93,0
"Lessor township, Polk County, Minnesota",139,139,0,0,0,0,0,139,0,139,139,0
"Liberty township, Polk County, Minnesota",60,60,0,0,0,0,0,60,0,60,60,0
"Lowell township, Polk County, Minnesota",443,381,24,58,0,0,0,443,28,415,428,15
"McIntosh city, Polk County, Minnesota",607,574,6,9,20,0,0,607,13,594,605,2
"Mentor city, Polk County, Minnesota",186,185,0,0,6,0,2,186,8,178,179,7
"Nesbit township, Polk County, Minnesota",87,83,4,0,0,0,0,87,0,87,87,0
"Nielsville city, Polk County, Minnesota",132,132,0,0,0,0,0,132,43,89,132,0
"Northland township, Polk County, Minnesota",127,127,0,0,0,0,0,127,0,127,127,0
"Onstad township, Polk County, Minnesota",87,87,0,0,0,0,0,87,7,80,87,0
"Parnell township, Polk County, Minnesota",43,43,0,0,0,0,0,43,0,43,43,0
"Queen township, Polk County, Minnesota",180,176,0,0,4,0,0,180,0,180,180,0
"Reis township, Polk County, Minnesota",69,69,0,0,0,0,1,69,1,68,68,1
"Rhinehart township, Polk County, Minnesota",134,134,0,0,0,0,0,134,4,130,134,0
"Roome township, Polk County, Minnesota",115,113,0,2,0,0,0,115,8,107,115,0
"Rosebud township, Polk County, Minnesota",326,326,0,3,0,0,0,326,0,326,323,3
"Russia township, Polk County, Minnesota",31,31,0,0,0,0,0,31,0,31,31,0
"Sandsville township, Polk County, Minnesota",42,42,0,0,0,0,0,42,0,42,42,0
"Scandia township, Polk County, Minnesota",39,39,0,0,0,0,0,39,0,39,39,0
"Sletten township, Polk County, Minnesota",228,228,0,0,0,0,0,228,0,228,228,0
"Sullivan township, Polk County, Minnesota",144,144,0,0,0,0,0,144,4,140,144,0
"Tabor township, Polk County, Minnesota",70,70,0,0,0,0,0,70,0,70,70,0
"Trail city, Polk County, Minnesota",68,68,12,15,0,0,0,68,0,68,53,15
"Tynsid township, Polk County, Minnesota",42,42,0,0,0,0,0,42,0,42,42,0
"Vineland township, Polk County, Minnesota",118,112,0,6,0,0,0,118,3,115,118,0
"Winger city, Polk County, Minnesota",205,196,0,20,0,0,0,205,0,205,194,11
"Winger township, Polk County, Minnesota",198,196,0,2,0,0,0,198,0,198,198,0
"Woodside township, Polk County, Minnesota",456,446,0,10,0,0,0,456,0,456,456,0
"Bangor township, Pope County, Minnesota",193,193,0,0,0,0,0,193,0,193,193,0
"Barsness township, Pope County, Minnesota",82,80,0,2,0,0,0,82,0,82,82,0
"Ben Wade township, Pope County, Minnesota",255,253,2,0,0,0,0,255,0,255,255,0
"Blue Mounds township, Pope County, Minnesota",189,185,0,2,4,0,0,189,0,189,187,2
"Brooten city, Pope County, Minnesota",0,0,0,0,0,0,0,0,0,0,0,0
"Chippewa Falls township, Pope County, Minnesota",214,214,0,0,0,0,0,214,5,209,214,0
"Cyrus city, Pope County, Minnesota",349,343,0,0,11,11,0,349,16,333,338,11
"Farwell city, Pope County, Minnesota",35,35,0,0,0,0,0,35,0,35,35,0
"Gilchrist township, Pope County, Minnesota",211,205,20,0,0,0,0,211,0,211,197,14
"Glenwood city, Pope County, Minnesota",2521,2506,9,0,0,0,6,2521,16,2505,2521,0
"Glenwood township, Pope County, Minnesota",1070,1028,8,13,25,0,7,1070,21,1049,1059,11
"Grove Lake township, Pope County, Minnesota",275,220,8,0,3,0,44,275,52,223,275,0
"Hoff township, Pope County, Minnesota",104,102,2,0,0,0,0,104,0,104,104,0
"Lake Johanna township, Pope County, Minnesota",93,93,0,0,0,0,0,93,5,88,93,0
"Langhei township, Pope County, Minnesota",169,169,0,0,0,0,0,169,0,169,169,0
"Leven township, Pope County, Minnesota",494,494,0,0,0,0,0,494,0,494,494,0
"Long Beach city, Pope County, Minnesota",310,304,6,0,0,0,0,310,2,308,310,0
"Lowry city, Pope County, Minnesota",419,405,0,0,17,0,3,419,5,414,413,6
"Minnewaska township, Pope County, Minnesota",500,500,0,0,0,0,0,500,0,500,500,0
"New Prairie township, Pope County, Minnesota",227,225,0,0,0,0,2,227,2,225,227,0
"Nora township, Pope County, Minnesota",208,203,3,2,0,0,0,208,0,208,208,0
"Reno township, Pope County, Minnesota",364,353,11,5,0,0,0,364,0,364,359,5
"Rolling Forks township, Pope County, Minnesota",159,159,0,0,0,0,0,159,0,159,159,0
"Sedan city, Pope County, Minnesota",54,54,0,0,0,0,0,54,0,54,54,0
"Starbuck city, Pope County, Minnesota",1323,1297,26,37,12,0,0,1323,0,1323,1274,49
"Villard city, Pope County, Minnesota",243,241,0,9,6,0,0,243,2,241,230,13
"Walden township, Pope County, Minnesota",161,161,3,0,0,0,0,161,0,161,158,3
"Westport city, Pope County, Minnesota",43,31,0,0,0,0,12,43,12,31,43,0
"Westport township, Pope County, Minnesota",259,259,0,0,0,0,0,259,0,259,259,0
"White Bear Lake township, Pope County, Minnesota",408,408,0,0,0,0,0,408,3,405,408,0
"Arden Hills city, Ramsey County, Minnesota",10250,9390,284,179,762,12,70,10250,309,9941,9848,402
"Blaine city, Ramsey County, Minnesota",0,0,0,0,0,0,0,0,0,0,0,0
"Falcon Heights city, Ramsey County, Minnesota",5560,4232,490,14,863,13,110,5560,140,5420,5398,162
"Gem Lake city, Ramsey County, Minnesota",501,480,5,0,16,0,8,501,12,489,493,8
"Lauderdale city, Ramsey County, Minnesota",2501,1733,378,48,388,0,16,2501,60,2441,2439,62
"Little Canada city, Ramsey County, Minnesota",10321,7774,1103,142,1726,0,139,10321,584,9737,9809,512
"Maplewood city, Ramsey County, Minnesota",40127,29424,4652,791,6452,38,643,40127,3046,37081,38407,1720
"Mounds View city, Ramsey County, Minnesota",12872,10415,1056,205,1154,51,506,12872,748,12124,12391,481
"New Brighton city, Ramsey County, Minnesota",22440,18763,2206,246,1487,6,598,22440,1191,21249,21599,841
"North Oaks city, Ramsey County, Minnesota",4961,4724,48,14,192,0,19,4961,152,4809,4925,36
"North St. Paul city, Ramsey County, Minnesota",12241,9731,1314,107,1231,17,231,12241,599,11642,11872,369
"Roseville city, Ramsey County, Minnesota",35624,28937,3382,677,3721,115,561,35624,1349,34275,34092,1532
"St. Anthony city, Ramsey County, Minnesota",3370,2595,598,22,232,9,38,3370,263,3107,3255,115
"St. Paul city, Ramsey County, Minnesota",300820,185748,55657,7274,57698,709,10253,300820,29207,271613,285995,14825
"Shoreview city, Ramsey County, Minnesota",26432,23313,764,162,2556,64,208,26432,827,25605,25797,635
"Spring Lake Park city, Ramsey County, Minnesota",242,93,9,0,149,0,0,242,0,242,233,9
"Vadnais Heights city, Ramsey County, Minnesota",13283,11358,859,25,1252,0,149,13283,509,12774,12923,360
"White Bear township, Ramsey County, Minnesota",11414,11097,120,100,394,0,15,11414,323,11091,11130,284
"White Bear Lake city, Ramsey County, Minnesota",24934,22883,841,265,1731,25,101,24934,629,24305,24183,751
"Brooks city, Red Lake County, Minnesota",120,120,0,6,0,0,0,120,0,120,114,6
"Browns Creek township, Red Lake County, Minnesota",40,40,0,0,0,0,0,40,3,37,40,0
"Emardville township, Red Lake County, Minnesota",244,244,0,0,0,0,0,244,28,216,244,0
"Equality township, Red Lake County, Minnesota",131,126,5,3,0,0,0,131,5,126,128,3
"Garnes township, Red Lake County, Minnesota",175,175,0,0,0,0,0,175,0,175,175,0
"Gervais township, Red Lake County, Minnesota",225,195,0,28,0,0,2,225,2,223,225,0
"Lake Pleasant township, Red Lake County, Minnesota",75,67,0,0,8,0,0,75,7,68,75,0
"Lambert township, Red Lake County, Minnesota",163,163,0,0,0,0,0,163,0,163,163,0
"Louisville township, Red Lake County, Minnesota",124,120,0,0,4,0,0,124,6,118,124,0
"Oklee city, Red Lake County, Minnesota",410,390,6,28,8,0,0,410,0,410,388,22
"Plummer city, Red Lake County, Minnesota",410,399,0,15,0,0,0,410,42,368,406,4
"Poplar River township, Red Lake County, Minnesota",82,67,0,0,0,0,15,82,15,67,82,0
"Red Lake Falls city, Red Lake County, Minnesota",1366,1342,20,20,0,0,20,1366,32,1334,1332,34
"Red Lake Falls township, Red Lake County, Minnesota",142,142,0,0,0,0,0,142,0,142,142,0
"River township, Red Lake County, Minnesota",96,96,0,0,0,0,0,96,0,96,96,0
"Terrebonne township, Red Lake County, Minnesota",157,153,3,4,3,0,0,157,0,157,151,6
"Wylie township, Red Lake County, Minnesota",57,57,0,0,0,0,0,57,0,57,57,0
"Belview city, Redwood County, Minnesota",364,362,0,0,2,0,0,364,12,352,364,0
"Brookville township, Redwood County, Minnesota",152,152,0,0,0,0,0,152,0,152,152,0
"Charlestown township, Redwood County, Minnesota",248,218,0,0,2,0,28,248,28,220,248,0
"Clements city, Redwood County, Minnesota",186,162,0,9,18,0,0,186,47,139,183,3
"Delhi city, Redwood County, Minnesota",30,30,0,0,0,0,0,30,0,30,30,0
"Delhi township, Redwood County, Minnesota",295,287,2,3,3,0,0,295,6,289,295,0
"Gales township, Redwood County, Minnesota",147,147,0,0,0,0,0,147,0,147,147,0
"Granite Rock township, Redwood County, Minnesota",183,183,0,0,0,0,0,183,0,183,183,0
"Honner township, Redwood County, Minnesota",113,113,0,0,0,0,0,113,2,111,113,0
"Johnsonville township, Redwood County, Minnesota",183,183,0,0,0,0,0,183,0,183,183,0
"Kintire township, Redwood County, Minnesota",216,208,0,2,0,0,8,216,21,195,214,2
"Lamberton city, Redwood County, Minnesota",775,754,10,0,11,0,10,775,17,758,765,10
"Lamberton township, Redwood County, Minnesota",176,171,0,0,0,0,8,176,8,168,173,3
"Lucan city, Redwood County, Minnesota",164,162,2,0,0,0,0,164,5,159,164,0
"Milroy city, Redwood County, Minnesota",212,212,0,0,0,0,0,212,0,212,212,0
"Morgan city, Redwood County, Minnesota",902,878,12,19,0,0,7,902,24,878,893,9
"Morgan township, Redwood County, Minnesota",255,251,0,4,0,0,0,255,0,255,255,0
"New Avon township, Redwood County, Minnesota",193,193,0,0,0,0,0,193,0,193,193,0
"North Hero township, Redwood County, Minnesota",157,137,0,0,20,0,0,157,0,157,157,0
"Paxton township, Redwood County, Minnesota",585,373,20,225,21,0,0,585,7,578,531,54
"Redwood Falls city, Redwood County, Minnesota",5031,4461,93,326,46,17,142,5031,217,4814,4977,54
"Redwood Falls township, Redwood County, Minnesota",173,169,0,4,0,2,0,173,0,173,171,2
"Revere city, Redwood County, Minnesota",94,85,0,0,9,0,0,94,0,94,94,0
"Sanborn city, Redwood County, Minnesota",317,309,0,0,0,0,8,317,12,305,317,0
"Seaforth city, Redwood County, Minnesota",78,78,0,0,0,0,0,78,0,78,78,0
"Sheridan township, Redwood County, Minnesota",177,177,0,0,0,0,0,177,0,177,177,0
"Sherman township, Redwood County, Minnesota",412,182,5,219,0,0,8,412,49,363,410,2
"Springdale township, Redwood County, Minnesota",183,183,0,0,0,0,0,183,0,183,183,0
"Sundown township, Redwood County, Minnesota",220,197,0,3,20,0,0,220,0,220,220,0
"Swedes Forest township, Redwood County, Minnesota",176,167,0,9,0,0,0,176,0,176,176,0
"Three Lakes township, Redwood County, Minnesota",151,151,0,0,0,0,0,151,0,151,151,0
"Underwood township, Redwood County, Minnesota",121,121,0,2,0,0,0,121,0,121,119,2
"Vail township, Redwood County, Minnesota",168,164,0,4,0,0,0,168,0,168,168,0
"Vesta city, Redwood County, Minnesota",286,286,0,0,0,0,0,286,3,283,286,0
"Vesta township, Redwood County, Minnesota",235,235,0,0,0,0,0,235,0,235,235,0
"Wabasso city, Redwood County, Minnesota",737,703,9,0,13,0,25,737,13,724,724,13
"Walnut Grove city, Redwood County, Minnesota",702,377,0,3,325,0,0,702,0,702,699,3
"Wanda city, Redwood County, Minnesota",69,69,0,0,6,0,0,69,3,66,63,6
"Waterbury township, Redwood County, Minnesota",163,161,0,0,0,0,2,163,2,161,163,0
"Westline township, Redwood County, Minnesota",185,183,2,0,2,0,0,185,0,185,183,2
"Willow Lake township, Redwood County, Minnesota",216,216,0,5,0,0,0,216,4,212,211,5
"Bandon township, Renville County, Minnesota",185,185,0,0,0,0,0,185,13,172,185,0
"Beaver Falls township, Renville County, Minnesota",184,173,0,11,0,0,0,184,7,177,184,0
"Birch Cooley township, Renville County, Minnesota",161,148,0,28,0,0,0,161,0,161,146,15
"Bird Island city, Renville County, Minnesota",867,867,0,6,0,0,0,867,5,862,861,6
"Bird Island township, Renville County, Minnesota",201,201,0,4,0,0,0,201,0,201,197,4
"Boon Lake township, Renville County, Minnesota",367,353,0,0,1,0,14,367,16,351,366,1
"Brookfield township, Renville County, Minnesota",162,162,0,0,0,0,0,162,0,162,162,0
"Buffalo Lake city, Renville County, Minnesota",759,661,13,24,31,0,61,759,135,624,728,31
"Cairo township, Renville County, Minnesota",209,207,4,7,2,0,0,209,7,202,198,11
"Camp township, Renville County, Minnesota",159,144,0,0,4,0,13,159,13,146,157,2
"Crooks township, Renville County, Minnesota",194,183,11,0,0,0,0,194,0,194,194,0
"Danube city, Renville County, Minnesota",585,534,0,0,0,0,51,585,94,491,585,0
"Emmet township, Renville County, Minnesota",220,215,0,0,5,0,0,220,0,220,220,0
"Ericson township, Renville County, Minnesota",230,225,4,4,3,0,5,230,5,225,223,7
"Fairfax city, Renville County, Minnesota",992,867,22,3,15,0,92,992,103,889,985,7
"Flora township, Renville County, Minnesota",165,165,0,0,0,0,0,165,0,165,165,0
"Franklin city, Renville County, Minnesota",531,472,4,59,7,10,0,531,22,509,514,17
"Hawk Creek township, Renville County, Minnesota",197,189,3,11,0,0,0,197,2,195,191,6
"Hector city, Renville County, Minnesota",954,870,8,5,0,0,81,954,95,859,949,5
"Hector township, Renville County, Minnesota",220,215,0,0,5,5,0,220,0,220,215,5
"Henryville township, Renville County, Minnesota",158,158,0,0,0,0,0,158,0,158,158,0
"Kingman township, Renville County, Minnesota",211,211,0,0,0,0,0,211,0,211,211,0
"Martinsburg township, Renville County, Minnesota",152,148,0,4,0,0,0,152,0,152,152,0
"Melville township, Renville County, Minnesota",216,211,5,3,0,0,0,216,0,216,213,3
"Morton city, Renville County, Minnesota",355,311,0,52,0,0,1,355,1,354,346,9
"Norfolk township, Renville County, Minnesota",122,121,0,0,2,0,0,122,4,118,121,1
"Olivia city, Renville County, Minnesota",2437,2240,23,7,13,0,198,2437,341,2096,2400,37
"Osceola township, Renville County, Minnesota",142,142,0,0,0,0,0,142,0,142,142,0
"Palmyra township, Renville County, Minnesota",192,192,0,3,0,0,0,192,0,192,189,3
"Preston Lake township, Renville County, Minnesota",201,201,0,0,0,0,0,201,0,201,201,0
"Redwood Falls city, Renville County, Minnesota",0,0,0,0,0,0,0,0,0,0,0,0
"Renville city, Renville County, Minnesota",1427,1216,1,0,40,0,173,1427,250,1177,1424,3
"Sacred Heart city, Renville County, Minnesota",486,455,0,0,0,0,31,486,57,429,486,0
"Sacred Heart township, Renville County, Minnesota",275,272,0,8,3,0,0,275,0,275,267,8
"Troy township, Renville County, Minnesota",266,266,0,0,0,0,0,266,0,266,266,0
"Wang township, Renville County, Minnesota",217,217,0,0,0,0,0,217,7,210,217,0
"Wellington township, Renville County, Minnesota",198,193,0,0,0,0,5,198,5,193,198,0
"Winfield township, Renville County, Minnesota",201,175,0,30,0,0,0,201,0,201,197,4
"Bridgewater township, Rice County, Minnesota",1863,1830,0,0,17,0,16,1863,56,1807,1863,0
"Cannon City township, Rice County, Minnesota",1123,1117,10,9,0,0,0,1123,7,1116,1110,13
"Dennison city, Rice County, Minnesota",6,6,0,0,0,0,0,6,0,6,6,0
"Dundas city, Rice County, Minnesota",1586,1522,21,7,39,0,14,1586,69,1517,1569,17
"Erin township, Rice County, Minnesota",947,933,7,5,3,0,26,947,30,917,922,25
"Faribault city, Rice County, Minnesota",23577,19012,2701,471,867,21,1195,23577,2698,20879,22972,605
"Forest township, Rice County, Minnesota",1194,1191,5,1,3,0,0,1194,37,1157,1188,6
"Lonsdale city, Rice County, Minnesota",3850,3826,39,5,0,0,0,3850,85,3765,3830,20
"Morristown city, Rice County, Minnesota",1019,1007,16,2,5,0,0,1019,95,924,1008,11
"Morristown township, Rice County, Minnesota",623,620,0,0,3,0,0,623,25,598,623,0
"Nerstrand city, Rice County, Minnesota",352,352,0,0,0,0,1,352,8,344,351,1
"Northfield city, Rice County, Minnesota",19146,17247,523,86,914,14,790,19146,1765,17381,18730,416
"Northfield township, Rice County, Minnesota",804,796,3,5,3,0,3,804,20,784,798,6
"Richland township, Rice County, Minnesota",361,344,0,0,0,0,17,361,17,344,361,0
"Shieldsville township, Rice County, Minnesota",943,932,0,0,22,0,0,943,5,938,932,11
"Walcott township, Rice County, Minnesota",888,881,0,1,2,0,4,888,8,880,888,0
"Warsaw township, Rice County, Minnesota",1441,1438,0,0,3,0,0,1441,0,1441,1441,0
"Webster township, Rice County, Minnesota",1926,1897,14,45,26,0,0,1926,10,1916,1879,47
"Wells township, Rice County, Minnesota",1699,1685,14,0,14,0,2,1699,166,1533,1683,16
"Wheatland township, Rice County, Minnesota",1249,1238,4,0,6,4,11,1249,18,1231,1243,6
"Wheeling township, Rice County, Minnesota",654,650,0,0,1,0,3,654,10,644,654,0
"Battle Plain township, Rock County, Minnesota",188,187,0,1,0,0,0,188,0,188,188,0
"Beaver Creek city, Rock County, Minnesota",371,346,25,0,0,0,0,371,0,371,371,0
"Beaver Creek township, Rock County, Minnesota",416,392,32,4,1,0,0,416,9,407,403,13
"Clinton township, Rock County, Minnesota",205,205,0,1,0,0,0,205,0,205,204,1
"Denver township, Rock County, Minnesota",155,155,0,0,0,0,0,155,0,155,155,0
"Hardwick city, Rock County, Minnesota",225,220,0,5,0,0,0,225,0,225,225,0
"Hills city, Rock County, Minnesota",714,701,18,0,1,0,0,714,0,714,708,6
"Jasper city, Rock County, Minnesota",40,40,0,0,0,0,0,40,0,40,40,0
"Kanaranzi township, Rock County, Minnesota",225,225,0,0,0,0,0,225,3,222,225,0
"Kenneth city, Rock County, Minnesota",74,74,0,0,0,0,0,74,0,74,74,0
"Luverne city, Rock County, Minnesota",4587,4405,45,65,76,0,33,4587,204,4383,4562,25
"Luverne township, Rock County, Minnesota",468,468,0,0,0,0,0,468,0,468,468,0
"Magnolia city, Rock County, Minnesota",245,205,5,7,26,0,8,245,31,214,239,6
"Magnolia township, Rock County, Minnesota",217,207,0,0,0,0,10,217,14,203,217,0
"Martin township, Rock County, Minnesota",362,357,0,2,3,0,0,362,2,360,362,0
"Mound township, Rock County, Minnesota",234,234,0,0,0,0,0,234,0,234,234,0
"Rose Dell township, Rock County, Minnesota",136,134,0,0,0,0,2,136,2,134,136,0
"Springwater township, Rock County, Minnesota",232,232,0,0,0,0,0,232,0,232,232,0
"Steen city, Rock County, Minnesota",203,202,1,0,0,0,1,203,1,202,202,1
"Vienna township, Rock County, Minnesota",136,136,0,0,0,0,0,136,0,136,136,0
"Badger city, Roseau County, Minnesota",450,428,13,17,19,0,1,450,4,446,422,28
"Barnett township, Roseau County, Minnesota",179,177,0,0,6,0,0,179,0,179,175,4
"Barto township, Roseau County, Minnesota",125,125,0,0,0,0,0,125,4,121,125,0
"Beaver township, Roseau County, Minnesota",67,67,0,0,0,0,0,67,0,67,67,0
"Cedarbend township, Roseau County, Minnesota",227,196,12,15,25,0,0,227,0,227,206,21
"Deer township, Roseau County, Minnesota",130,130,0,0,0,0,0,130,0,130,130,0
"Dewey township, Roseau County, Minnesota",109,109,0,0,0,0,0,109,14,95,109,0
"Dieter township, Roseau County, Minnesota",145,137,1,2,7,0,0,145,0,145,143,2
"Enstrom township, Roseau County, Minnesota",443,406,0,37,0,0,0,443,0,443,443,0
"Falun township, Roseau County, Minnesota",265,265,0,0,2,0,0,265,0,265,263,2
"Golden Valley township, Roseau County, Minnesota",195,178,4,2,15,0,0,195,0,195,191,4
"Greenbush city, Roseau County, Minnesota",840,779,58,3,0,3,0,840,0,840,837,3
"Grimstad township, Roseau County, Minnesota",120,120,0,0,0,0,0,120,0,120,120,0
"Hereim township, Roseau County, Minnesota",216,207,9,0,0,0,0,216,0,216,216,0
"Huss township, Roseau County, Minnesota",139,139,0,0,0,0,0,139,9,130,139,0
"Jadis township, Roseau County, Minnesota",601,593,0,0,3,0,5,601,5,596,601,0
"Lake township, Roseau County, Minnesota",2070,1992,0,97,66,0,7,2070,47,2023,1978,92
"Laona township, Roseau County, Minnesota",378,372,0,16,4,0,7,378,19,359,357,21
"Lind township, Roseau County, Minnesota",19,19,0,0,0,0,0,19,0,19,19,0
"Malung township, Roseau County, Minnesota",398,394,0,0,4,0,0,398,0,398,398,0
"Mickinock township, Roseau County, Minnesota",287,287,0,0,6,0,2,287,2,285,279,8
"Moose township, Roseau County, Minnesota",125,125,0,0,0,0,0,125,0,125,125,0
"Moranville township, Roseau County, Minnesota",820,803,4,26,14,0,0,820,12,808,793,27
"Nereson township, Roseau County, Minnesota",28,28,0,0,0,0,0,28,0,28,28,0
"North Roseau UT, Roseau County, Minnesota",134,134,0,0,0,0,0,134,0,134,134,0
"Northwest Roseau UT, Roseau County, Minnesota",63,63,0,0,0,0,0,63,0,63,63,0
"Palmville township, Roseau County, Minnesota",28,28,0,0,0,0,0,28,0,28,28,0
"Pohlitz township, Roseau County, Minnesota",19,19,0,0,0,0,0,19,0,19,19,0
"Polonia township, Roseau County, Minnesota",15,15,0,0,0,0,0,15,0,15,15,0
"Poplar Grove township, Roseau County, Minnesota",59,59,0,0,0,0,0,59,0,59,59,0
"Reine township, Roseau County, Minnesota",132,132,0,0,0,0,0,132,0,132,132,0
"Roosevelt city, Roseau County, Minnesota",138,138,0,0,0,0,0,138,0,138,138,0
"Roseau city, Roseau County, Minnesota",2681,2618,21,63,11,7,17,2681,33,2648,2627,54
"Ross township, Roseau County, Minnesota",363,361,0,2,2,0,0,363,2,361,361,2
"Skagen township, Roseau County, Minnesota",273,270,0,0,3,0,0,273,1,272,273,0
"Soler township, Roseau County, Minnesota",112,112,0,0,0,0,0,112,0,112,112,0
"Southeast Roseau UT, Roseau County, Minnesota",226,226,0,0,0,0,0,226,0,226,226,0
"Spruce township, Roseau County, Minnesota",551,525,26,0,11,0,0,551,25,526,540,11
"Stafford township, Roseau County, Minnesota",258,252,0,0,9,0,0,258,0,258,255,3
"Stokes township, Roseau County, Minnesota",183,183,0,0,0,0,0,183,0,183,183,0
"Strathcona city, Roseau County, Minnesota",37,37,0,0,0,0,0,37,0,37,37,0
"Warroad city, Roseau County, Minnesota",1889,1495,15,104,296,16,0,1889,4,1885,1852,37
"County subdivisions not defined, St. Louis County, Minnesota",0,0,0,0,0,0,0,0,0,0,0,0
"Alango township, St. Louis County, Minnesota",199,196,0,7,0,0,0,199,3,196,195,4
"Alborn township, St. Louis County, Minnesota",508,488,2,39,0,0,0,508,12,496,487,21
"Alden township, St. Louis County, Minnesota",190,174,1,2,16,0,0,190,3,187,187,3
"Angora township, St. Louis County, Minnesota",241,225,3,19,0,0,0,241,0,241,235,6
"Arrowhead township, St. Louis County, Minnesota",250,212,0,33,5,0,0,250,0,250,250,0
"Ault township, St. Louis County, Minnesota",120,120,0,0,0,0,0,120,3,117,120,0
"Babbitt city, St. Louis County, Minnesota",1496,1488,4,53,0,0,0,1496,4,1492,1447,49
"Balkan township, St. Louis County, Minnesota",854,849,3,0,2,0,3,854,8,846,851,3
"Bassett township, St. Louis County, Minnesota",32,28,0,4,0,0,0,32,0,32,32,0
"Beatty township, St. Louis County, Minnesota",500,500,2,4,0,0,0,500,1,499,496,4
"Birch Lake UT, St. Louis County, Minnesota",362,362,0,0,0,0,0,362,0,362,362,0
"Biwabik city, St. Louis County, Minnesota",852,852,9,31,0,0,0,852,17,835,821,31
"Biwabik township, St. Louis County, Minnesota",788,782,0,5,3,2,0,788,11,777,786,2
"Breitung township, St. Louis County, Minnesota",510,505,0,5,0,0,0,510,0,510,510,0
"Brevator township, St. Louis County, Minnesota",1282,986,4,320,0,0,2,1282,6,1276,1252,30
"Brookston city, St. Louis County, Minnesota",155,149,0,12,0,0,0,155,0,155,149,6
"Buhl city, St. Louis County, Minnesota",1011,975,39,34,14,0,0,1011,0,1011,960,51
"Camp 5 township, St. Louis County, Minnesota",21,21,0,0,0,0,0,21,0,21,21,0
"Canosia township, St. Louis County, Minnesota",2374,2358,16,18,0,0,5,2374,23,2351,2351,23
"Cedar Valley township, St. Louis County, Minnesota",245,242,9,0,3,0,0,245,5,240,236,9
"Cherry township, St. Louis County, Minnesota",838,832,19,18,0,0,0,838,3,835,809,29
"Chisholm city, St. Louis County, Minnesota",4974,4953,21,14,5,5,0,4974,79,4895,4955,19
"Clinton township, St. Louis County, Minnesota",1070,1020,42,41,6,0,10,1070,8,1062,1021,49
"Colvin township, St. Louis County, Minnesota",333,332,0,3,0,0,0,333,0,333,331,2
"Cook city, St. Louis County, Minnesota",538,530,0,15,0,3,6,538,0,538,522,16
"Cotton township, St. Louis County, Minnesota",537,530,2,23,0,0,2,537,8,529,517,20
"Crane Lake township, St. Louis County, Minnesota",76,76,0,0,0,0,0,76,0,76,76,0
"Culver township, St. Louis County, Minnesota",312,300,0,16,0,0,0,312,0,312,308,4
"Duluth city, St. Louis County, Minnesota",86066,80143,3465,3086,2055,115,402,86066,1972,84094,83112,2954
"Duluth township, St. Louis County, Minnesota",1886,1867,25,16,6,0,0,1886,27,1859,1858,28
"Eagles Nest township, St. Louis County, Minnesota",254,251,2,2,8,0,0,254,2,252,245,9
"Ellsburg township, St. Louis County, Minnesota",180,180,0,0,0,0,0,180,0,180,180,0
"Elmer township, St. Louis County, Minnesota",121,121,0,0,0,0,0,121,0,121,121,0
"Ely city, St. Louis County, Minnesota",3425,3382,34,15,15,0,0,3425,18,3407,3404,21
"Embarrass township, St. Louis County, Minnesota",544,537,1,7,7,0,0,544,0,544,536,8
"Eveleth city, St. Louis County, Minnesota",3649,3602,26,109,14,0,16,3649,16,3633,3549,100
"Fairbanks township, St. Louis County, Minnesota",53,53,0,1,0,0,0,53,0,53,52,1
"Fayal township, St. Louis County, Minnesota",1774,1755,7,20,7,0,0,1774,4,1770,1759,15
"Field township, St. Louis County, Minnesota",404,387,1,16,0,0,0,404,14,390,404,0
"Fine Lakes township, St. Louis County, Minnesota",118,118,0,1,0,0,0,118,0,118,117,1
"Floodwood city, St. Louis County, Minnesota",471,468,5,3,0,0,2,471,2,469,464,7
"Floodwood township, St. Louis County, Minnesota",335,335,5,4,0,0,0,335,0,335,326,9
"Fredenberg township, St. Louis County, Minnesota",1493,1456,12,3,27,0,13,1493,9,1484,1475,18
"French township, St. Louis County, Minnesota",526,521,0,0,12,0,0,526,0,526,519,7
"Gheen UT, St. Louis County, Minnesota",19,19,0,0,0,0,0,19,0,19,19,0
"Gilbert city, St. Louis County, Minnesota",1750,1704,43,1,4,1,0,1750,0,1750,1748,2
"Gnesen township, St. Louis County, Minnesota",1789,1706,33,7,41,4,25,1789,0,1789,1762,27
"Grand Lake township, St. Louis County, Minnesota",2797,2737,27,113,12,0,0,2797,60,2737,2705,92
"Great Scott township, St. Louis County, Minnesota",372,360,5,6,6,0,1,372,10,362,366,6
"Greenwood township, St. Louis County, Minnesota",966,774,3,279,6,0,0,966,12,954,870,96
"Halden township, St. Louis County, Minnesota",132,130,0,2,0,0,0,132,0,132,132,0
"Hay Lake UT, St. Louis County, Minnesota",80,80,0,0,0,0,0,80,0,80,80,0
"Hermantown city, St. Louis County, Minnesota",9603,8961,456,150,13,0,91,9603,193,9410,9535,68
"Hibbing city, St. Louis County, Minnesota",16183,15532,331,220,343,14,128,16183,232,15951,15798,385
"Hoyt Lakes city, St. Louis County, Minnesota",2086,2086,0,28,5,0,0,2086,0,2086,2053,33
"Industrial township, St. Louis County, Minnesota",797,780,12,13,0,6,3,797,20,777,782,15
"Iron Junction city, St. Louis County, Minnesota",111,108,0,0,5,0,0,111,0,111,109,2
"Janette Lake UT, St. Louis County, Minnesota",211,211,0,0,0,0,0,211,0,211,211,0
"Kabetogama township, St. Louis County, Minnesota",128,128,0,2,0,0,0,128,0,128,126,2
"Kelsey township, St. Louis County, Minnesota",143,129,0,8,4,0,6,143,0,143,139,4
"Kinney city, St. Louis County, Minnesota",155,155,0,19,0,0,0,155,2,153,136,19
"Kugler township, St. Louis County, Minnesota",160,131,0,29,0,0,0,160,3,157,160,0
"Lakewood township, St. Louis County, Minnesota",2294,2262,0,23,14,0,13,2294,59,2235,2276,18
"Lavell township, St. Louis County, Minnesota",306,302,0,1,0,0,4,306,0,306,305,1
"Leiding township, St. Louis County, Minnesota",420,353,6,91,0,0,0,420,0,420,394,26
"Leonidas city, St. Louis County, Minnesota",41,41,0,0,0,0,0,41,0,41,41,0
"Linden Grove township, St. Louis County, Minnesota",140,139,0,1,0,0,0,140,0,140,140,0
"McCormack UT, St. Louis County, Minnesota",119,119,0,0,0,0,0,119,0,119,119,0
"McDavitt township, St. Louis County, Minnesota",442,429,1,15,0,0,0,442,10,432,439,3
"McKinley city, St. Louis County, Minnesota",210,208,0,3,2,0,0,210,0,210,207,3
"Makinen UT, St. Louis County, Minnesota",1392,1382,0,32,0,10,0,1392,0,1392,1360,32
"Meadowlands city, St. Louis County, Minnesota",120,103,10,7,2,0,0,120,0,120,118,2
"Meadowlands township, St. Louis County, Minnesota",296,296,9,0,0,0,0,296,0,296,287,9
"Midway township, St. Louis County, Minnesota",1483,1452,0,45,7,0,0,1483,0,1483,1462,21
"Morcom township, St. Louis County, Minnesota",51,51,0,2,0,0,0,51,0,51,49,2
"Morse township, St. Louis County, Minnesota",1272,1263,3,8,11,0,0,1272,8,1264,1259,13
"Mountain Iron city, St. Louis County, Minnesota",2875,2830,25,49,14,0,0,2875,7,2868,2832,43
"Ness township, St. Louis County, Minnesota",67,65,0,2,0,0,0,67,1,66,67,0
"Nett Lake UT, St. Louis County, Minnesota",333,125,12,306,0,0,4,333,8,325,224,109
"New Independence township, St. Louis County, Minnesota",296,293,0,12,0,0,0,296,0,296,287,9
"Normanna township, St. Louis County, Minnesota",802,762,15,23,12,0,0,802,6,796,792,10
"Northeast St. Louis UT, St. Louis County, Minnesota",224,224,0,0,0,0,0,224,0,224,224,0
"Northland township, St. Louis County, Minnesota",251,215,0,34,3,0,0,251,0,251,250,1
"North Star township, St. Louis County, Minnesota",226,217,2,7,4,2,0,226,4,222,220,6
"Northwest St. Louis UT, St. Louis County, Minnesota",410,410,0,43,0,0,0,410,0,410,367,43
"Orr city, St. Louis County, Minnesota",276,229,0,68,0,0,0,276,10,266,255,21
"Owens township, St. Louis County, Minnesota",232,227,2,4,0,0,0,232,1,231,231,1
"Pequaywan township, St. Louis County, Minnesota",149,147,0,0,4,0,0,149,0,149,147,2
"Pike township, St. Louis County, Minnesota",420,413,19,26,0,0,0,420,0,420,401,19
"Portage township, St. Louis County, Minnesota",175,175,6,24,0,0,0,175,0,175,145,30
"Potshot Lake UT, St. Louis County, Minnesota",44,44,0,0,0,0,0,44,0,44,44,0
"Prairie Lake township, St. Louis County, Minnesota",35,35,0,0,0,0,0,35,0,35,35,0
"Proctor city, St. Louis County, Minnesota",3045,2946,9,7,83,13,0,3045,97,2948,3032,13
"Rice Lake city, St. Louis County, Minnesota",4139,4073,12,92,42,0,11,4139,11,4128,4048,91
"Sand Lake UT, St. Louis County, Minnesota",907,889,2,0,16,0,0,907,0,907,907,0
"Sandy township, St. Louis County, Minnesota",398,398,0,0,0,0,0,398,2,396,398,0
"Solway township, St. Louis County, Minnesota",1902,1872,0,46,0,0,0,1902,10,1892,1886,16
"Stoney Brook township, St. Louis County, Minnesota",316,231,2,93,7,0,0,316,4,312,299,17
"Sturgeon township, St. Louis County, Minnesota",135,132,0,0,5,0,0,135,0,135,133,2
"Toivola township, St. Louis County, Minnesota",199,190,0,2,9,0,0,199,0,199,197,2
"Tower city, St. Louis County, Minnesota",675,658,20,255,0,0,0,675,5,670,422,253
"Van Buren township, St. Louis County, Minnesota",148,148,0,0,0,0,0,148,0,148,148,0
"Vermilion Lake township, St. Louis County, Minnesota",281,281,0,0,0,0,0,281,3,278,281,0
"Virginia city, St. Louis County, Minnesota",8570,7952,153,627,86,0,23,8570,85,8485,8299,271
"Waasa township, St. Louis County, Minnesota",261,261,4,0,0,0,0,261,0,261,257,4
"White township, St. Louis County, Minnesota",3209,3110,9,30,81,0,0,3209,1,3208,3188,21
"Whiteface Reservoir UT, St. Louis County, Minnesota",416,416,0,0,0,0,0,416,0,416,416,0
"Willow Valley township, St. Louis County, Minnesota",114,102,0,14,0,0,2,114,0,114,110,4
"Winton city, St. Louis County, Minnesota",131,131,0,0,0,0,0,131,0,131,131,0
"Wuori township, St. Louis County, Minnesota",598,590,5,11,0,0,0,598,2,596,590,8
"Belle Plaine city, Scott County, Minnesota",6935,6489,93,61,100,0,218,6935,393,6542,6909,26
"Belle Plaine township, Scott County, Minnesota",1013,1008,2,0,2,2,0,1013,24,989,1012,1
"Blakeley township, Scott County, Minnesota",399,394,0,1,6,0,0,399,0,399,397,2
"Cedar Lake township, Scott County, Minnesota",2944,2913,19,12,107,0,0,2944,16,2928,2849,95
"Credit River township, Scott County, Minnesota",5458,5172,1,100,183,0,29,5458,102,5356,5431,27
"Elko New Market city, Scott County, Minnesota",4556,4457,20,12,115,0,0,4556,21,4535,4508,48
"Helena township, Scott County, Minnesota",1735,1726,6,9,4,0,0,1735,17,1718,1725,10
"Jackson township, Scott County, Minnesota",1691,1231,6,61,41,0,403,1691,654,1037,1640,51
"Jordan city, Scott County, Minnesota",6079,5417,105,0,45,107,405,6079,553,5526,6079,0
"Louisville township, Scott County, Minnesota",1263,1143,0,3,86,0,34,1263,55,1208,1260,3
"New Market township, Scott County, Minnesota",3633,3550,13,19,46,31,31,3633,7,3626,3586,47
"New Prague city, Scott County, Minnesota",4507,4334,0,98,77,0,45,4507,191,4316,4460,47
"Prior Lake city, Scott County, Minnesota",25452,23105,559,678,1606,35,396,25452,693,24759,24580,872
"St. Lawrence township, Scott County, Minnesota",470,470,0,8,0,0,0,470,6,464,462,8
"Sand Creek township, Scott County, Minnesota",1585,1561,3,16,34,0,4,1585,70,1515,1552,33
"Savage city, Scott County, Minnesota",30011,24964,2371,231,2821,44,481,30011,941,29070,29126,885
"Shakopee city, Scott County, Minnesota",40024,31433,3365,679,4550,79,1739,40024,3112,36912,38281,1743
"Spring Lake township, Scott County, Minnesota",3708,3655,0,14,60,0,0,3708,96,3612,3687,21
"Baldwin township, Sherburne County, Minnesota",6962,6920,14,78,12,0,0,6962,7,6955,6900,62
"Becker city, Sherburne County, Minnesota",4734,4472,34,183,137,0,0,4734,25,4709,4642,92
"Becker township, Sherburne County, Minnesota",5184,5034,178,59,18,0,0,5184,0,5184,5079,105
"Big Lake city, Sherburne County, Minnesota",10516,9659,498,164,22,0,422,10516,839,9677,10267,249
"Big Lake township, Sherburne County, Minnesota",7621,7524,5,39,170,0,0,7621,44,7577,7504,117
"Blue Hill township, Sherburne County, Minnesota",2086,2040,26,3,27,0,31,2086,36,2050,2045,41
"Clear Lake city, Sherburne County, Minnesota",594,572,16,19,2,8,2,594,5,589,569,25
"Clear Lake township, Sherburne County, Minnesota",1743,1709,20,3,17,12,0,1743,12,1731,1725,18
"Elk River city, Sherburne County, Minnesota",23924,22460,737,395,612,29,371,23924,443,23481,23389,535
"Haven township, Sherburne County, Minnesota",1863,1821,12,7,5,0,25,1863,25,1838,1856,7
"Livonia township, Sherburne County, Minnesota",6148,6061,289,32,173,32,0,6148,186,5962,5793,355
"Orrock township, Sherburne County, Minnesota",3563,3403,67,39,74,0,55,3563,125,3438,3488,75
"Palmer township, Sherburne County, Minnesota",2504,2457,26,0,13,0,8,2504,28,2476,2504,0
"Princeton city, Sherburne County, Minnesota",145,145,0,0,0,0,0,145,0,145,145,0
"St. Cloud city, Sherburne County, Minnesota",6991,5701,990,94,232,0,24,6991,349,6642,6941,50
"Santiago township, Sherburne County, Minnesota",2026,2003,26,11,12,4,8,2026,8,2018,1994,32
"Zimmerman city, Sherburne County, Minnesota",5420,5376,35,18,129,0,0,5420,165,5255,5300,120
"Alfsborg township, Sibley County, Minnesota",252,250,0,0,2,0,0,252,0,252,252,0
"Arlington city, Sibley County, Minnesota",2179,2148,20,18,20,0,15,2179,539,1640,2137,42
"Arlington township, Sibley County, Minnesota",528,520,3,3,10,0,0,528,0,528,520,8
"Bismarck township, Sibley County, Minnesota",312,298,0,0,14,0,0,312,0,312,312,0
"Cornish township, Sibley County, Minnesota",197,187,0,6,0,0,4,197,4,193,197,0
"Dryden township, Sibley County, Minnesota",349,347,0,3,0,2,0,349,23,326,346,3
"Faxon township, Sibley County, Minnesota",629,625,0,0,0,0,4,629,11,618,629,0
"Gaylord city, Sibley County, Minnesota",2015,1857,28,8,56,0,66,2015,376,1639,2015,0
"Gibbon city, Sibley County, Minnesota",857,831,50,0,0,0,0,857,83,774,833,24
"Grafton township, Sibley County, Minnesota",237,237,0,0,0,0,0,237,8,229,237,0
"Green Isle city, Sibley County, Minnesota",615,606,12,3,0,2,8,615,56,559,602,13
"Green Isle township, Sibley County, Minnesota",513,494,19,7,0,0,0,513,31,482,506,7
"Henderson city, Sibley County, Minnesota",848,834,14,4,0,2,9,848,15,833,833,15
"Henderson township, Sibley County, Minnesota",750,749,0,0,5,0,0,750,0,750,746,4
"Jessenland township, Sibley County, Minnesota",441,440,1,0,0,0,0,441,18,423,441,0
"Kelso township, Sibley County, Minnesota",244,238,2,5,3,0,0,244,7,237,240,4
"Le Sueur city, Sibley County, Minnesota",0,0,0,0,0,0,0,0,0,0,0,0
"Moltke township, Sibley County, Minnesota",310,310,0,0,0,0,2,310,0,310,308,2
"New Auburn city, Sibley County, Minnesota",525,525,0,0,0,0,0,525,12,513,525,0
"New Auburn township, Sibley County, Minnesota",481,480,0,0,1,0,0,481,0,481,481,0
"Severance township, Sibley County, Minnesota",309,309,0,15,0,0,0,309,5,304,294,15
"Sibley township, Sibley County, Minnesota",279,275,0,0,0,0,4,279,0,279,279,0
"Transit township, Sibley County, Minnesota",273,273,0,0,0,0,0,273,0,273,273,0
"Washington Lake township, Sibley County, Minnesota",426,425,0,0,4,0,0,426,0,426,423,3
"Winthrop city, Sibley County, Minnesota",1319,1305,2,7,5,0,0,1319,88,1231,1319,0
"Albany city, Stearns County, Minnesota",2674,2579,94,27,19,0,3,2674,50,2624,2626,48
"Albany township, Stearns County, Minnesota",1058,1050,0,0,40,0,0,1058,0,1058,1026,32
"Ashley township, Stearns County, Minnesota",254,253,0,1,0,0,0,254,3,251,254,0
"Avon city, Stearns County, Minnesota",1707,1707,0,0,0,0,0,1707,19,1688,1707,0
"Avon township, Stearns County, Minnesota",2262,2237,10,0,24,9,0,2262,10,2252,2244,18
"Belgrade city, Stearns County, Minnesota",899,883,0,1,11,0,5,899,7,892,898,1
"Brockway township, Stearns County, Minnesota",2815,2774,0,4,71,0,0,2815,19,2796,2781,34
"Brooten city, Stearns County, Minnesota",570,546,24,4,0,0,3,570,31,539,565,5
"Clearwater city, Stearns County, Minnesota",0,0,0,0,0,0,0,0,0,0,0,0
"Cold Spring city, Stearns County, Minnesota",4067,4023,0,0,19,0,85,4067,205,3862,4007,60
"Collegeville township, Stearns County, Minnesota",3449,3155,136,36,140,6,49,3449,137,3312,3384,65
"Crow Lake township, Stearns County, Minnesota",360,360,0,5,0,0,0,360,0,360,355,5
"Crow River township, Stearns County, Minnesota",325,325,0,0,0,0,0,325,3,322,325,0
"Eden Lake township, Stearns County, Minnesota",1470,1440,14,15,3,2,2,1470,2,1468,1464,6
"Eden Valley city, Stearns County, Minnesota",482,465,12,5,0,0,0,482,5,477,482,0
"Elrosa city, Stearns County, Minnesota",166,164,2,1,0,0,0,166,0,166,165,1
"Fair Haven township, Stearns County, Minnesota",1634,1634,18,1,0,0,0,1634,0,1634,1615,19
"Farming township, Stearns County, Minnesota",934,934,0,4,0,0,0,934,0,934,930,4
"Freeport city, Stearns County, Minnesota",783,728,0,0,0,0,55,783,57,726,783,0
"Getty township, Stearns County, Minnesota",387,387,0,0,0,0,0,387,31,356,387,0
"Greenwald city, Stearns County, Minnesota",232,232,0,0,0,0,0,232,0,232,232,0
"Grove township, Stearns County, Minnesota",556,542,0,0,9,0,5,556,5,551,556,0
"Holding township, Stearns County, Minnesota",1345,1345,0,0,0,0,0,1345,2,1343,1345,0
"Holdingford city, Stearns County, Minnesota",597,595,0,0,2,0,0,597,7,590,597,0
"Kimball city, Stearns County, Minnesota",882,813,2,0,73,53,0,882,9,873,823,59
"Krain township, Stearns County, Minnesota",921,915,0,0,0,0,10,921,12,909,917,4
"Lake George township, Stearns County, Minnesota",239,239,0,0,0,0,0,239,0,239,239,0
"Lake Henry city, Stearns County, Minnesota",63,63,0,0,0,0,0,63,0,63,63,0
"Lake Henry township, Stearns County, Minnesota",269,266,0,0,3,0,0,269,2,267,269,0
"Le Sauk township, Stearns County, Minnesota",1711,1672,28,0,28,4,5,1711,13,1698,1693,18
"Luxemburg township, Stearns County, Minnesota",659,655,4,0,0,0,8,659,15,644,651,8
"Lynden township, Stearns County, Minnesota",1852,1808,8,18,16,0,19,1852,18,1834,1835,17
"Maine Prairie township, Stearns County, Minnesota",1841,1834,7,0,0,0,9,1841,17,1824,1832,9
"Meire Grove city, Stearns County, Minnesota",192,192,0,0,0,0,0,192,0,192,192,0
"Melrose city, Stearns County, Minnesota",3619,3415,39,0,0,0,190,3619,638,2981,3594,25
"Melrose township, Stearns County, Minnesota",763,763,0,0,0,0,0,763,0,763,763,0
"Millwood township, Stearns County, Minnesota",1015,1015,0,0,2,0,0,1015,1,1014,1013,2
"Munson township, Stearns County, Minnesota",1638,1633,7,7,23,9,0,1638,2,1636,1618,20
"New Munich city, Stearns County, Minnesota",348,348,0,0,0,0,0,348,0,348,348,0
"North Fork township, Stearns County, Minnesota",310,310,0,0,0,0,0,310,1,309,310,0
"Oak township, Stearns County, Minnesota",665,665,0,3,0,0,0,665,8,657,662,3
"Paynesville city, Stearns County, Minnesota",2717,2586,0,9,30,7,89,2717,208,2509,2713,4
"Paynesville township, Stearns County, Minnesota",1319,1309,1,1,19,0,5,1319,5,1314,1303,16
"Raymond township, Stearns County, Minnesota",225,225,0,0,0,0,0,225,0,225,225,0
"Richmond city, Stearns County, Minnesota",1585,1581,8,1,4,0,0,1585,42,1543,1576,9
"Rockville city, Stearns County, Minnesota",2513,2239,24,0,0,0,250,2513,314,2199,2513,0
"Roscoe city, Stearns County, Minnesota",106,103,0,0,0,0,4,106,4,102,105,1
"St. Anthony city, Stearns County, Minnesota",117,117,0,0,0,0,0,117,0,117,117,0
"St. Augusta city, Stearns County, Minnesota",3613,3561,10,5,45,0,0,3613,4,3609,3605,8
"St. Cloud city, Stearns County, Minnesota",53626,44585,6775,748,2314,165,659,53626,1525,52101,52222,1404
"St. Joseph city, Stearns County, Minnesota",6862,6519,188,70,156,5,28,6862,88,6774,6762,100
"St. Joseph township, Stearns County, Minnesota",1360,1357,8,4,3,14,0,1360,5,1355,1334,26
"St. Martin city, Stearns County, Minnesota",341,324,1,0,0,0,17,341,17,324,340,1
"St. Martin township, Stearns County, Minnesota",525,525,0,0,0,0,0,525,0,525,525,0
"St. Rosa city, Stearns County, Minnesota",70,70,0,0,0,0,0,70,0,70,70,0
"St. Stephen city, Stearns County, Minnesota",936,890,5,0,14,0,29,936,41,895,934,2
"St. Wendel township, Stearns County, Minnesota",2233,2214,6,0,25,0,12,2233,19,2214,2209,24
"Sartell city, Stearns County, Minnesota",14656,13618,269,27,809,0,132,14656,265,14391,14478,178
"Sauk Centre city, Stearns County, Minnesota",4350,4136,51,0,40,0,154,4350,306,4044,4319,31
"Sauk Centre township, Stearns County, Minnesota",1102,1102,0,0,0,0,0,1102,0,1102,1102,0
"Spring Hill city, Stearns County, Minnesota",65,65,0,0,0,0,0,65,0,65,65,0
"Spring Hill township, Stearns County, Minnesota",350,350,0,0,0,0,0,350,0,350,350,0
"Waite Park city, Stearns County, Minnesota",7457,5586,1252,11,302,44,492,7457,767,6690,7237,220
"Wakefield township, Stearns County, Minnesota",2870,2870,0,7,0,0,10,2870,10,2860,2853,17
"Zion township, Stearns County, Minnesota",289,289,0,0,0,0,0,289,2,287,289,0
"Aurora township, Steele County, Minnesota",486,486,2,0,1,0,0,486,0,486,483,3
"Berlin township, Steele County, Minnesota",461,461,0,0,2,0,0,461,0,461,459,2
"Blooming Prairie city, Steele County, Minnesota",1949,1913,5,4,0,0,31,1949,131,1818,1945,4
"Blooming Prairie township, Steele County, Minnesota",408,408,0,0,0,0,0,408,7,401,408,0
"Clinton Falls township, Steele County, Minnesota",406,405,4,0,1,0,0,406,0,406,402,4
"Deerfield township, Steele County, Minnesota",519,514,0,3,1,0,1,519,13,506,519,0
"Ellendale city, Steele County, Minnesota",778,745,23,0,12,0,0,778,0,778,776,2
"Havana township, Steele County, Minnesota",710,582,0,0,33,0,95,710,98,612,710,0
"Lemond township, Steele County, Minnesota",475,458,0,0,5,0,13,475,19,456,474,1
"Medford city, Steele County, Minnesota",1309,1184,20,0,19,4,106,1309,142,1167,1292,17
"Medford township, Steele County, Minnesota",746,641,6,0,5,0,94,746,222,524,746,0
"Meriden township, Steele County, Minnesota",613,608,5,0,0,0,0,613,0,613,613,0
"Merton township, Steele County, Minnesota",391,386,0,2,0,0,3,391,3,388,391,0
"Owatonna city, Steele County, Minnesota",25613,23145,1284,169,461,27,899,25613,2031,23582,25241,372
"Owatonna township, Steele County, Minnesota",542,524,0,0,4,0,14,542,56,486,542,0
"Somerset township, Steele County, Minnesota",803,791,6,0,4,0,2,803,11,792,803,0
"Summit township, Steele County, Minnesota",403,400,1,0,0,3,0,403,0,403,402,1
"Alberta city, Stevens County, Minnesota",157,157,0,0,0,0,0,157,0,157,157,0
"Baker township, Stevens County, Minnesota",104,104,0,0,0,0,0,104,10,94,104,0
"Chokio city, Stevens County, Minnesota",428,410,0,0,18,0,0,428,0,428,428,0
"Darnen township, Stevens County, Minnesota",251,251,0,0,0,0,0,251,36,215,251,0
"Donnelly city, Stevens County, Minnesota",271,271,0,0,0,0,0,271,29,242,271,0
"Donnelly township, Stevens County, Minnesota",55,55,0,0,0,0,0,55,2,53,55,0
"Eldorado township, Stevens County, Minnesota",46,46,0,0,0,0,0,46,0,46,46,0
"Everglade township, Stevens County, Minnesota",124,124,0,0,0,0,0,124,0,124,124,0
"Framnas township, Stevens County, Minnesota",354,354,0,0,0,0,0,354,0,354,354,0
"Hancock city, Stevens County, Minnesota",816,775,0,15,56,0,21,816,37,779,765,51
"Hodges township, Stevens County, Minnesota",294,294,0,0,0,0,0,294,74,220,294,0
"Horton township, Stevens County, Minnesota",148,148,0,0,0,0,0,148,0,148,148,0
"Moore township, Stevens County, Minnesota",235,235,0,0,0,0,0,235,105,130,235,0
"Morris city, Stevens County, Minnesota",5326,4888,124,203,139,26,7,5326,175,5151,5265,61
"Morris township, Stevens County, Minnesota",432,393,0,39,0,0,0,432,0,432,432,0
"Pepperton township, Stevens County, Minnesota",108,103,0,0,15,0,0,108,0,108,98,10
"Rendsville township, Stevens County, Minnesota",165,165,0,0,0,0,0,165,0,165,165,0
"Scott township, Stevens County, Minnesota",134,134,0,0,0,0,0,134,0,134,134,0
"Stevens township, Stevens County, Minnesota",61,61,0,0,0,0,0,61,0,61,61,0
"Swan Lake township, Stevens County, Minnesota",152,152,0,0,0,0,0,152,0,152,152,0
"Synnes township, Stevens County, Minnesota",98,93,5,0,0,0,0,98,20,78,98,0
"Appleton city, Swift County, Minnesota",1449,1359,34,24,0,9,60,1449,103,1346,1420,29
"Appleton township, Swift County, Minnesota",182,182,0,0,0,0,0,182,1,181,182,0
"Benson city, Swift County, Minnesota",3113,2881,188,1,24,0,19,3113,86,3027,3113,0
"Benson township, Swift County, Minnesota",285,281,12,0,0,0,0,285,7,278,277,8
"Camp Lake township, Swift County, Minnesota",136,136,0,0,0,0,0,136,0,136,136,0
"Cashel township, Swift County, Minnesota",159,159,0,0,0,0,0,159,21,138,159,0
"Clontarf city, Swift County, Minnesota",126,126,0,0,0,0,0,126,0,126,126,0
"Clontarf township, Swift County, Minnesota",62,62,0,0,0,0,0,62,1,61,62,0
"Danvers city, Swift County, Minnesota",139,139,0,0,0,0,0,139,0,139,139,0
"De Graff city, Swift County, Minnesota",159,159,0,0,0,0,0,159,0,159,159,0
"Dublin township, Swift County, Minnesota",150,150,0,2,0,0,0,150,0,150,148,2
"Edison township, Swift County, Minnesota",88,88,0,0,0,0,0,88,0,88,88,0
"Fairfield township, Swift County, Minnesota",105,103,0,0,0,0,2,105,2,103,105,0
"Hayes township, Swift County, Minnesota",197,197,0,0,0,0,0,197,2,195,197,0
"Hegbert township, Swift County, Minnesota",110,110,0,0,0,0,2,110,2,108,108,2
"Holloway city, Swift County, Minnesota",110,110,0,0,0,0,0,110,0,110,110,0
"Kerkhoven city, Swift County, Minnesota",691,642,0,0,0,0,49,691,139,552,691,0
"Kerkhoven township, Swift County, Minnesota",228,228,0,0,0,0,0,228,0,228,228,0
"Kildare township, Swift County, Minnesota",119,119,0,0,0,0,0,119,0,119,119,0
"Marysland township, Swift County, Minnesota",111,111,0,0,0,0,0,111,0,111,111,0
"Moyer township, Swift County, Minnesota",71,71,0,0,0,0,0,71,0,71,71,0
"Murdock city, Swift County, Minnesota",285,266,0,0,0,3,16,285,16,269,285,0
"Pillsbury township, Swift County, Minnesota",282,281,0,0,1,1,0,282,8,274,281,1
"Shible township, Swift County, Minnesota",140,138,0,0,2,0,0,140,0,140,140,0
"Six Mile Grove township, Swift County, Minnesota",160,160,0,0,0,0,0,160,4,156,160,0
"Swenoda township, Swift County, Minnesota",122,122,2,0,0,0,0,122,1,121,120,2
"Tara township, Swift County, Minnesota",101,100,1,0,0,0,0,101,1,100,101,0
"Torning township, Swift County, Minnesota",403,402,0,0,1,0,0,403,0,403,403,0
"West Bank township, Swift County, Minnesota",165,133,0,0,0,2,32,165,34,131,163,2
"Bartlett township, Todd County, Minnesota",504,504,0,0,0,0,0,504,0,504,504,0
"Bertha city, Todd County, Minnesota",641,628,4,20,4,0,3,641,0,641,623,18
"Bertha township, Todd County, Minnesota",380,353,27,0,0,0,0,380,2,378,380,0
"Birchdale township, Todd County, Minnesota",677,677,0,0,0,0,0,677,11,666,677,0
"Browerville city, Todd County, Minnesota",780,701,34,12,58,0,20,780,24,756,740,40
"Bruce township, Todd County, Minnesota",537,528,0,0,9,0,0,537,0,537,537,0
"Burleene township, Todd County, Minnesota",367,358,3,0,6,0,0,367,8,359,367,0
"Burnhamville township, Todd County, Minnesota",678,678,0,0,0,0,0,678,7,671,678,0
"Burtrum city, Todd County, Minnesota",133,133,0,0,2,0,0,133,0,133,131,2
"Clarissa city, Todd County, Minnesota",799,781,23,33,14,0,3,799,19,780,744,55
"Eagle Bend city, Todd County, Minnesota",450,450,0,0,0,0,0,450,4,446,450,0
"Eagle Valley township, Todd County, Minnesota",464,464,15,26,0,2,0,464,2,462,421,43
"Fawn Lake township, Todd County, Minnesota",399,399,4,0,24,0,0,399,0,399,371,28
"Germania township, Todd County, Minnesota",498,498,0,0,0,0,0,498,0,498,498,0
"Gordon township, Todd County, Minnesota",666,666,0,0,0,0,0,666,2,664,666,0
"Grey Eagle city, Todd County, Minnesota",399,379,0,3,16,0,8,399,8,391,392,7
"Grey Eagle township, Todd County, Minnesota",549,549,9,0,0,0,0,549,1,548,540,9
"Hartford township, Todd County, Minnesota",691,691,0,0,0,0,0,691,6,685,691,0
"Hewitt city, Todd County, Minnesota",228,228,3,0,0,0,3,228,3,225,222,6
"Iona township, Todd County, Minnesota",560,558,0,12,0,0,2,560,2,558,548,12
"Kandota township, Todd County, Minnesota",760,744,22,16,0,0,0,760,0,760,744,16
"Leslie township, Todd County, Minnesota",548,530,19,0,4,4,1,548,4,544,538,10
"Little Elk township, Todd County, Minnesota",219,216,0,0,2,0,3,219,3,216,217,2
"Little Sauk township, Todd County, Minnesota",851,851,0,2,0,0,0,851,2,849,849,2
"Long Prairie city, Todd County, Minnesota",3346,3064,37,67,1,0,230,3346,1112,2234,3293,53
"Long Prairie township, Todd County, Minnesota",958,951,0,15,4,0,9,958,11,947,937,21
"Moran township, Todd County, Minnesota",487,478,4,17,0,0,0,487,0,487,475,12
"Osakis city, Todd County, Minnesota",164,164,25,0,0,0,0,164,0,164,139,25
"Reynolds township, Todd County, Minnesota",599,599,0,14,0,0,0,599,0,599,585,14
"Round Prairie township, Todd County, Minnesota",859,859,16,30,0,0,0,859,13,846,813,46
"Staples city, Todd County, Minnesota",2147,2098,2,22,0,0,44,2147,83,2064,2128,19
"Staples township, Todd County, Minnesota",516,493,0,23,0,0,0,516,4,512,516,0
"Stowe Prairie township, Todd County, Minnesota",427,427,0,4,0,0,0,427,0,427,423,4
"Swanville city, Todd County, Minnesota",3,3,0,0,0,0,0,3,0,3,3,0
"Turtle Creek township, Todd County, Minnesota",256,255,0,0,0,0,1,256,1,255,256,0
"Villard township, Todd County, Minnesota",634,584,24,32,43,0,0,634,13,621,589,45
"Ward township, Todd County, Minnesota",470,470,0,0,0,0,0,470,1,469,470,0
"West Union city, Todd County, Minnesota",132,132,0,0,0,0,0,132,0,132,132,0
"West Union township, Todd County, Minnesota",250,250,0,0,0,0,0,250,0,250,250,0
"Wykeham township, Todd County, Minnesota",397,389,0,4,3,5,5,397,1,396,388,9
"Arthur township, Traverse County, Minnesota",90,90,0,0,0,0,0,90,0,90,90,0
"Browns Valley city, Traverse County, Minnesota",522,400,4,150,2,10,0,522,0,522,478,44
"Clifton township, Traverse County, Minnesota",58,58,0,0,0,0,0,58,0,58,58,0
"Croke township, Traverse County, Minnesota",103,103,0,0,0,0,0,103,0,103,103,0
"Dollymount township, Traverse County, Minnesota",23,23,0,0,0,0,0,23,0,23,23,0
"Dumont city, Traverse County, Minnesota",121,121,0,0,0,0,0,121,2,119,121,0
"Folsom township, Traverse County, Minnesota",97,86,0,0,11,0,0,97,0,97,97,0
"Lake Valley township, Traverse County, Minnesota",263,263,0,0,0,0,0,263,0,263,263,0
"Leonardsville township, Traverse County, Minnesota",121,121,0,0,0,0,0,121,0,121,121,0
"Monson township, Traverse County, Minnesota",81,81,0,0,0,0,0,81,0,81,81,0
"Parnell township, Traverse County, Minnesota",23,23,0,0,0,0,0,23,0,23,23,0
"Redpath township, Traverse County, Minnesota",33,33,0,0,0,0,0,33,0,33,33,0
"Tara township, Traverse County, Minnesota",123,123,0,0,0,0,0,123,0,123,123,0
"Taylor township, Traverse County, Minnesota",61,61,1,0,0,0,0,61,2,59,60,1
"Tintah city, Traverse County, Minnesota",34,34,0,0,0,0,0,34,0,34,34,0
"Tintah township, Traverse County, Minnesota",23,23,0,0,0,0,0,23,0,23,23,0
"Walls township, Traverse County, Minnesota",30,30,0,0,0,0,0,30,0,30,30,0
"Wheaton city, Traverse County, Minnesota",1508,1449,33,28,8,0,14,1508,77,1431,1484,24
"Windsor township, Traverse County, Minnesota",43,43,0,0,0,0,0,43,2,41,43,0
"Bellechester city, Wabasha County, Minnesota",45,43,0,2,0,0,0,45,2,43,45,0
"Chester township, Wabasha County, Minnesota",473,473,0,0,0,0,0,473,0,473,473,0
"Elgin city, Wabasha County, Minnesota",1301,1301,14,4,23,9,0,1301,48,1253,1260,41
"Elgin township, Wabasha County, Minnesota",682,648,22,17,22,0,6,682,22,660,649,33
"Gillford township, Wabasha County, Minnesota",532,530,0,1,2,0,0,532,1,531,531,1
"Glasgow township, Wabasha County, Minnesota",165,165,0,2,0,0,0,165,0,165,163,2
"Greenfield township, Wabasha County, Minnesota",1346,1340,0,7,12,0,0,1346,24,1322,1333,13
"Hammond city, Wabasha County, Minnesota",77,72,5,0,0,0,0,77,15,62,77,0
"Highland township, Wabasha County, Minnesota",481,476,0,0,5,0,0,481,0,481,481,0
"Hyde Park township, Wabasha County, Minnesota",266,266,0,0,0,0,0,266,0,266,266,0
"Kellogg city, Wabasha County, Minnesota",478,470,0,8,14,0,0,478,28,450,464,14
"Lake township, Wabasha County, Minnesota",540,534,30,0,0,0,0,540,0,540,516,24
"Lake City city, Wabasha County, Minnesota",4293,4219,55,40,0,0,9,4293,176,4117,4263,30
"Mazeppa city, Wabasha County, Minnesota",833,823,9,0,3,0,7,833,27,806,824,9
"Mazeppa township, Wabasha County, Minnesota",698,680,19,3,12,0,0,698,5,693,682,16
"Millville city, Wabasha County, Minnesota",152,150,0,0,0,0,6,152,11,141,148,4
"Minneiska city, Wabasha County, Minnesota",57,53,0,2,4,0,0,57,0,57,55,2
"Minneiska township, Wabasha County, Minnesota",136,136,0,0,0,0,0,136,3,133,136,0
"Mount Pleasant township, Wabasha County, Minnesota",433,433,0,0,0,0,0,433,0,433,433,0
"Oakwood township, Wabasha County, Minnesota",357,357,0,0,0,0,0,357,0,357,357,0
"Pepin township, Wabasha County, Minnesota",317,315,6,0,0,0,0,317,0,317,313,4
"Plainview city, Wabasha County, Minnesota",3275,3255,3,20,0,0,0,3275,113,3162,3272,3
"Plainview township, Wabasha County, Minnesota",476,476,0,0,0,0,0,476,20,456,476,0
"Wabasha city, Wabasha County, Minnesota",2576,2525,10,15,28,0,33,2576,97,2479,2541,35
"Watopa township, Wabasha County, Minnesota",254,254,0,0,0,0,0,254,3,251,254,0
"West Albany township, Wabasha County, Minnesota",356,356,0,0,0,0,0,356,0,356,356,0
"Zumbro township, Wabasha County, Minnesota",651,638,0,0,32,0,4,651,11,640,628,23
"Zumbro Falls city, Wabasha County, Minnesota",240,235,55,20,9,0,0,240,7,233,173,67
"Aldrich city, Wadena County, Minnesota",55,55,0,0,0,0,0,55,0,55,55,0
"Aldrich township, Wadena County, Minnesota",446,437,0,2,6,0,6,446,28,418,441,5
"Blueberry township, Wadena County, Minnesota",881,860,8,17,13,0,0,881,0,881,864,17
"Bullard township, Wadena County, Minnesota",175,175,0,0,0,0,0,175,0,175,175,0
"Huntersville township, Wadena County, Minnesota",103,100,3,0,3,0,0,103,0,103,100,3
"Leaf River township, Wadena County, Minnesota",530,474,36,19,0,0,4,530,5,525,527,3
"Lyons township, Wadena County, Minnesota",181,174,4,13,0,0,0,181,0,181,171,10
"Meadow township, Wadena County, Minnesota",219,219,0,0,0,0,0,219,0,219,219,0
"Menahga city, Wadena County, Minnesota",1168,1153,16,4,7,10,0,1168,9,1159,1156,12
"Nimrod city, Wadena County, Minnesota",97,97,0,0,0,0,0,97,0,97,97,0
"North Germany township, Wadena County, Minnesota",223,223,1,1,0,0,0,223,5,218,222,1
"Orton township, Wadena County, Minnesota",155,155,0,0,0,0,0,155,12,143,155,0
"Red Eye township, Wadena County, Minnesota",488,482,9,0,0,0,0,488,38,450,485,3
"Rockwood township, Wadena County, Minnesota",376,348,17,1,4,0,7,376,10,366,375,1
"Sebeka city, Wadena County, Minnesota",818,793,18,12,4,0,0,818,0,818,809,9
"Shell River township, Wadena County, Minnesota",277,258,0,5,19,0,0,277,0,277,272,5
"Staples city, Wadena County, Minnesota",861,861,0,0,24,0,0,861,0,861,837,24
"Thomastown township, Wadena County, Minnesota",746,739,0,0,0,0,7,746,27,719,746,0
"Verndale city, Wadena County, Minnesota",614,593,1,19,0,0,3,614,3,611,612,2
"Wadena city, Wadena County, Minnesota",3998,3888,108,66,0,0,0,3998,91,3907,3934,64
"Wadena township, Wadena County, Minnesota",767,760,3,4,0,0,0,767,13,754,767,0
"Wing River township, Wadena County, Minnesota",448,440,2,12,3,0,0,448,0,448,441,7
"Alton township, Waseca County, Minnesota",391,391,3,0,0,0,0,391,0,391,388,3
"Blooming Grove township, Waseca County, Minnesota",407,407,0,0,18,2,0,407,3,404,387,20
"Byron township, Waseca County, Minnesota",173,173,0,2,0,0,0,173,3,170,171,2
"Elysian city, Waseca County, Minnesota",8,8,0,0,0,0,0,8,0,8,8,0
"Freedom township, Waseca County, Minnesota",349,349,0,0,0,0,0,349,2,347,349,0
"Iosco township, Waseca County, Minnesota",449,446,0,3,0,1,0,449,8,441,448,1
"Janesville city, Waseca County, Minnesota",2663,2577,25,21,22,0,46,2663,101,2562,2635,28
"Janesville township, Waseca County, Minnesota",497,492,8,0,0,0,0,497,0,497,494,3
"New Richland city, Waseca County, Minnesota",1174,1150,2,0,14,0,10,1174,33,1141,1172,2
"New Richland township, Waseca County, Minnesota",402,396,0,0,0,0,6,402,6,396,402,0
"Otisco township, Waseca County, Minnesota",474,454,0,0,3,0,25,474,31,443,466,8
"St. Mary township, Waseca County, Minnesota",406,401,0,0,5,0,0,406,9,397,406,0
"Vivian township, Waseca County, Minnesota",228,222,0,0,3,0,3,228,3,225,228,0
"Waldorf city, Waseca County, Minnesota",188,180,0,0,10,0,0,188,0,188,186,2
"Waseca city, Waseca County, Minnesota",9151,8425,501,167,111,7,184,9151,799,8352,8907,244
"Wilton township, Waseca County, Minnesota",390,385,1,2,0,2,3,390,45,345,387,3
"Woodville township, Waseca County, Minnesota",1548,1504,11,0,28,0,11,1548,42,1506,1542,6
"Afton city, Washington County, Minnesota",2963,2804,44,3,112,15,27,2963,101,2862,2921,42
"Bayport city, Washington County, Minnesota",3688,2796,691,327,50,4,18,3688,106,3582,3492,196
"Baytown township, Washington County, Minnesota",1827,1791,6,4,31,0,5,1827,13,1814,1817,10
"Birchwood Village city, Washington County, Minnesota",897,887,8,0,4,0,0,897,0,897,895,2
"Cottage Grove city, Washington County, Minnesota",35902,30892,1965,516,3083,15,756,35902,1736,34166,34577,1325
"Dellwood city, Washington County, Minnesota",1149,1088,46,2,14,0,0,1149,16,1133,1148,1
"Denmark township, Washington County, Minnesota",1738,1715,14,7,6,0,6,1738,13,1725,1728,10
"Forest Lake city, Washington County, Minnesota",19406,18827,614,354,259,39,37,19406,397,19009,18814,592
"Grant city, Washington County, Minnesota",4140,4026,58,19,43,0,0,4140,57,4083,4134,6
"Grey Cloud Island township, Washington County, Minnesota",261,258,8,4,1,0,0,261,4,257,252,9
"Hastings city, Washington County, Minnesota",0,0,0,0,0,0,0,0,0,0,0,0
"Hugo city, Washington County, Minnesota",14415,13927,225,26,355,28,40,14415,336,14079,14229,186
"Lake Elmo city, Washington County, Minnesota",8621,8273,92,64,209,0,148,8621,350,8271,8456,165
"Lakeland city, Washington County, Minnesota",1893,1855,2,3,39,0,0,1893,15,1878,1887,6
"Lakeland Shores city, Washington County, Minnesota",332,331,0,0,2,0,1,332,1,331,330,2
"Lake St. Croix Beach city, Washington County, Minnesota",988,982,6,5,0,0,0,988,0,988,983,5
"Landfall city, Washington County, Minnesota",807,680,28,10,9,0,88,807,489,318,799,8
"Mahtomedi city, Washington County, Minnesota",8005,7528,293,69,237,0,32,8005,173,7832,7851,154
"Marine on St. Croix city, Washington County, Minnesota",755,737,26,11,33,0,0,755,7,748,703,52
"May township, Washington County, Minnesota",2873,2807,16,0,74,0,0,2873,20,2853,2849,24
"Newport city, Washington County, Minnesota",3485,3078,555,16,30,0,15,3485,78,3407,3292,193
"Oakdale city, Washington County, Minnesota",27972,22782,2879,427,2567,14,366,27972,1365,26607,27010,962
"Oak Park Heights city, Washington County, Minnesota",4823,4523,208,87,128,0,38,4823,71,4752,4676,147
"Pine Springs city, Washington County, Minnesota",389,372,7,1,2,2,9,389,18,371,385,4
"St. Marys Point city, Washington County, Minnesota",377,372,0,0,8,0,0,377,0,377,374,3
"St. Paul Park city, Washington County, Minnesota",5376,4953,80,160,446,85,40,5376,353,5023,5158,218
"Scandia city, Washington County, Minnesota",4044,3985,18,36,7,0,11,4044,160,3884,4031,13
"Stillwater city, Washington County, Minnesota",19232,18408,532,172,561,0,74,19232,503,18729,18752,480
"Stillwater township, Washington County, Minnesota",1819,1737,27,0,39,0,26,1819,4,1815,1809,10
"West Lakeland township, Washington County, Minnesota",4159,3893,103,0,205,0,0,4159,30,4129,4117,42
"White Bear Lake city, Washington County, Minnesota",477,466,0,0,19,0,0,477,0,477,469,8
"Willernie city, Washington County, Minnesota",518,518,11,0,0,0,0,518,28,490,507,11
"Woodbury city, Washington County, Minnesota",67648,56177,4801,490,7513,130,1215,67648,3403,64245,65128,2520
"Adrian township, Watonwan County, Minnesota",103,103,0,0,0,0,0,103,1,102,103,0
"Antrim township, Watonwan County, Minnesota",216,179,1,0,3,0,33,216,33,183,216,0
"Butterfield city, Watonwan County, Minnesota",545,446,1,24,64,0,23,545,134,411,532,13
"Butterfield township, Watonwan County, Minnesota",161,157,0,0,4,0,0,161,0,161,161,0
"Darfur city, Watonwan County, Minnesota",91,91,7,0,0,0,0,91,4,87,84,7
"Fieldon township, Watonwan County, Minnesota",233,231,2,0,0,0,0,233,0,233,233,0
"La Salle city, Watonwan County, Minnesota",69,69,0,0,0,0,0,69,0,69,69,0
"Lewisville city, Watonwan County, Minnesota",214,211,0,3,0,0,0,214,20,194,214,0
"Long Lake township, Watonwan County, Minnesota",297,297,0,0,0,0,2,297,2,295,295,2
"Madelia city, Watonwan County, Minnesota",2599,2326,103,39,57,0,169,2599,628,1971,2530,69
"Madelia township, Watonwan County, Minnesota",398,396,0,0,0,0,8,398,22,376,392,6
"Nelson township, Watonwan County, Minnesota",268,266,0,2,0,0,0,268,0,268,268,0
"Odin city, Watonwan County, Minnesota",95,95,0,0,0,0,0,95,0,95,95,0
"Odin township, Watonwan County, Minnesota",131,131,0,0,0,0,0,131,0,131,131,0
"Ormsby city, Watonwan County, Minnesota",92,92,0,0,0,0,0,92,0,92,92,0
"Riverdale township, Watonwan County, Minnesota",237,237,0,0,0,0,0,237,0,237,237,0
"Rosendale township, Watonwan County, Minnesota",344,338,0,0,6,0,0,344,0,344,344,0
"St. James city, Watonwan County, Minnesota",4454,3632,0,36,0,0,820,4454,1709,2745,4420,34
"St. James township, Watonwan County, Minnesota",216,216,0,0,0,0,0,216,0,216,216,0
"South Branch township, Watonwan County, Minnesota",173,173,0,0,0,0,0,173,0,173,173,0
"Akron township, Wilkin County, Minnesota",178,133,23,45,0,0,0,178,0,178,155,23
"Andrea township, Wilkin County, Minnesota",16,16,0,0,0,0,0,16,0,16,16,0
"Atherton township, Wilkin County, Minnesota",159,159,0,0,0,0,0,159,0,159,159,0
"Bradford township, Wilkin County, Minnesota",53,53,0,0,0,0,0,53,0,53,53,0
"Brandrup township, Wilkin County, Minnesota",145,145,0,0,0,0,0,145,0,145,145,0
"Breckenridge city, Wilkin County, Minnesota",3273,3112,68,158,0,0,0,3273,0,3273,3208,65
"Breckenridge township, Wilkin County, Minnesota",289,285,2,12,0,0,0,289,14,275,279,10
"Campbell city, Wilkin County, Minnesota",161,161,5,13,0,0,0,161,0,161,143,18
"Campbell township, Wilkin County, Minnesota",37,37,0,0,0,0,0,37,0,37,37,0
"Champion township, Wilkin County, Minnesota",35,35,0,0,0,0,0,35,0,35,35,0
"Connelly township, Wilkin County, Minnesota",91,82,0,9,0,0,0,91,0,91,91,0
"Deerhorn township, Wilkin County, Minnesota",80,80,0,10,0,0,0,80,0,80,70,10
"Doran city, Wilkin County, Minnesota",14,14,0,0,0,0,0,14,0,14,14,0
"Foxhome city, Wilkin County, Minnesota",119,119,0,0,0,0,0,119,0,119,119,0
"Foxhome township, Wilkin County, Minnesota",102,97,0,0,0,0,5,102,5,97,102,0
"Kent city, Wilkin County, Minnesota",71,71,0,3,0,0,0,71,0,71,68,3
"McCauleyville township, Wilkin County, Minnesota",20,20,0,0,0,0,0,20,0,20,20,0
"Manston township, Wilkin County, Minnesota",46,46,0,0,0,0,0,46,0,46,46,0
"Meadows township, Wilkin County, Minnesota",50,50,0,0,0,0,6,50,6,44,44,6
"Mitchell township, Wilkin County, Minnesota",82,82,0,0,0,0,0,82,0,82,82,0
"Nashua city, Wilkin County, Minnesota",12,12,0,0,0,0,0,12,0,12,12,0
"Nilsen township, Wilkin County, Minnesota",77,77,0,0,0,0,0,77,0,77,77,0
"Nordick township, Wilkin County, Minnesota",59,59,0,0,0,0,0,59,0,59,59,0
"Prairie View township, Wilkin County, Minnesota",294,294,0,0,0,0,0,294,0,294,294,0
"Roberts township, Wilkin County, Minnesota",137,137,0,0,0,0,0,137,0,137,137,0
"Rothsay city, Wilkin County, Minnesota",315,309,0,12,0,0,0,315,0,315,309,6
"Sunnyside township, Wilkin County, Minnesota",170,159,0,11,0,0,0,170,11,159,170,0
"Tanberg township, Wilkin County, Minnesota",68,68,0,0,0,0,0,68,0,68,68,0
"Wolverton city, Wilkin County, Minnesota",135,126,0,9,0,0,0,135,9,126,135,0
"Wolverton township, Wilkin County, Minnesota",110,110,0,0,0,0,0,110,0,110,110,0
"Altura city, Winona County, Minnesota",528,489,18,0,4,0,35,528,105,423,510,18
"Dakota city, Winona County, Minnesota",304,304,0,0,0,0,0,304,0,304,304,0
"Dresbach township, Winona County, Minnesota",425,422,0,0,10,0,0,425,2,423,418,7
"Elba city, Winona County, Minnesota",104,102,0,0,0,0,5,104,5,99,101,3
"Elba township, Winona County, Minnesota",374,358,0,0,0,0,16,374,33,341,374,0
"Fremont township, Winona County, Minnesota",301,298,0,0,5,2,0,301,44,257,297,4
"Goodview city, Winona County, Minnesota",4066,3986,43,131,0,0,18,4066,289,3777,3954,112
"Hart township, Winona County, Minnesota",313,307,0,4,14,0,0,313,0,313,301,12
"Hillsdale township, Winona County, Minnesota",907,850,4,20,13,0,24,907,85,822,903,4
"Homer township, Winona County, Minnesota",1275,1269,0,0,0,0,6,1275,0,1275,1275,0
"La Crescent city, Winona County, Minnesota",0,0,0,0,0,0,0,0,0,0,0,0
"Lewiston city, Winona County, Minnesota",1598,1509,51,0,33,0,37,1598,71,1527,1566,32
"Minneiska city, Winona County, Minnesota",45,45,0,0,0,0,0,45,0,45,45,0
"Minnesota City city, Winona County, Minnesota",166,166,2,0,0,0,0,166,45,121,164,2
"Mount Vernon township, Winona County, Minnesota",198,196,0,0,2,0,0,198,4,194,198,0
"New Hartford township, Winona County, Minnesota",928,896,4,2,26,0,0,928,3,925,928,0
"Norton township, Winona County, Minnesota",474,465,9,3,2,0,0,474,0,474,469,5
"Pleasant Hill township, Winona County, Minnesota",573,569,0,0,0,0,4,573,4,569,573,0
"Richmond township, Winona County, Minnesota",665,659,6,0,0,0,0,665,0,665,665,0
"Rollingstone city, Winona County, Minnesota",662,656,2,0,0,0,6,662,2,660,660,2
"Rollingstone township, Winona County, Minnesota",765,741,0,24,0,0,0,765,18,747,765,0
"St. Charles city, Winona County, Minnesota",3726,3079,35,0,552,31,95,3726,119,3607,3660,66
"St. Charles township, Winona County, Minnesota",646,642,23,0,0,0,4,646,15,631,623,23
"Saratoga township, Winona County, Minnesota",818,811,2,11,8,0,0,818,26,792,808,10
"Stockton city, Winona County, Minnesota",690,663,9,32,44,0,0,690,12,678,646,44
"Utica city, Winona County, Minnesota",318,318,17,1,0,0,0,318,23,295,300,18
"Utica township, Winona County, Minnesota",552,543,1,10,0,0,0,552,9,543,550,2
"Warren township, Winona County, Minnesota",826,738,10,0,96,0,2,826,0,826,806,20
"Whitewater township, Winona County, Minnesota",199,199,0,0,0,0,0,199,0,199,199,0
"Wilson township, Winona County, Minnesota",1105,1101,0,10,4,0,0,1105,45,1060,1095,10
"Winona city, Winona County, Minnesota",27153,25685,832,195,683,23,60,27153,445,26708,26873,280
"Wiscoy township, Winona County, Minnesota",288,288,0,2,0,0,0,288,14,274,286,2
"Albertville city, Wright County, Minnesota",7303,6666,203,0,538,0,0,7303,0,7303,7199,104
"Albion township, Wright County, Minnesota",1136,1131,5,0,0,0,3,1136,4,1132,1133,3
"Annandale city, Wright County, Minnesota",3332,2992,34,0,0,0,306,3332,318,3014,3332,0
"Buffalo city, Wright County, Minnesota",15996,15641,145,49,223,0,4,15996,230,15766,15930,66
"Buffalo township, Wright County, Minnesota",1896,1880,19,6,11,0,0,1896,11,1885,1876,20
"Chatham township, Wright County, Minnesota",1424,1416,0,0,15,0,4,1424,4,1420,1413,11
"Clearwater city, Wright County, Minnesota",1847,1789,18,12,14,0,18,1847,122,1725,1843,4
"Clearwater township, Wright County, Minnesota",1535,1516,16,0,8,0,0,1535,8,1527,1530,5
"Cokato city, Wright County, Minnesota",2732,2568,90,34,4,6,152,2732,308,2424,2614,118
"Cokato township, Wright County, Minnesota",1375,1375,0,0,0,0,0,1375,29,1346,1375,0
"Corinna township, Wright County, Minnesota",2339,2339,6,0,24,10,0,2339,24,2315,2309,30
"Dayton city, Wright County, Minnesota",0,0,0,0,0,0,0,0,0,0,0,0
"Delano city, Wright County, Minnesota",5854,5673,235,27,75,0,106,5854,52,5802,5614,240
"Franklin township, Wright County, Minnesota",2841,2831,0,20,15,0,0,2841,14,2827,2816,25
"French Lake township, Wright County, Minnesota",1148,1143,3,0,7,0,0,1148,7,1141,1143,5
"Hanover city, Wright County, Minnesota",2582,2513,0,15,68,0,0,2582,48,2534,2568,14
"Howard Lake city, Wright County, Minnesota",2061,1984,22,13,13,0,70,2061,140,1921,2020,41
"Maple Lake city, Wright County, Minnesota",2042,2019,2,53,0,0,20,2042,32,2010,1990,52
"Maple Lake township, Wright County, Minnesota",1881,1868,2,5,12,0,0,1881,21,1860,1875,6
"Marysville township, Wright County, Minnesota",2416,2321,11,76,44,0,0,2416,74,2342,2391,25
"Middleville township, Wright County, Minnesota",936,891,32,0,19,3,0,936,44,892,927,9
"Monticello city, Wright County, Minnesota",13316,12499,361,220,117,0,348,13316,836,12480,13087,229
"Monticello township, Wright County, Minnesota",3236,3167,15,30,43,0,28,3236,44,3192,3189,47
"Montrose city, Wright County, Minnesota",3105,3043,48,25,103,12,14,3105,163,2942,2977,128
"Otsego city, Wright County, Minnesota",15630,15018,505,103,299,0,56,15630,291,15339,15336,294
"Rockford city, Wright County, Minnesota",4017,3861,0,17,8,0,131,4017,398,3619,4017,0
"Rockford township, Wright County, Minnesota",3255,3194,38,13,18,0,0,3255,6,3249,3247,8
"St. Michael city, Wright County, Minnesota",17128,16065,619,165,460,0,93,17128,283,16845,16854,274
"Silver Creek township, Wright County, Minnesota",2502,2483,15,29,51,0,0,2502,35,2467,2426,76
"South Haven city, Wright County, Minnesota",171,166,0,2,3,0,0,171,3,168,171,0
"Southside township, Wright County, Minnesota",1620,1617,3,0,0,0,0,1620,0,1620,1620,0
"Stockholm township, Wright County, Minnesota",914,891,23,13,0,0,0,914,15,899,903,11
"Victor township, Wright County, Minnesota",1107,1079,0,2,0,0,28,1107,28,1079,1105,2
"Waverly city, Wright County, Minnesota",1444,1394,8,4,25,0,51,1444,40,1404,1406,38
"Woodland township, Wright County, Minnesota",1009,999,5,3,2,0,0,1009,0,1009,1009,0
"Burton township, Yellow Medicine County, Minnesota",118,118,0,0,0,0,0,118,1,117,118,0
"Canby city, Yellow Medicine County, Minnesota",1684,1679,0,9,5,0,6,1684,20,1664,1669,15
"Clarkfield city, Yellow Medicine County, Minnesota",850,841,0,21,0,0,2,850,4,846,836,14
"Echo city, Yellow Medicine County, Minnesota",260,239,18,3,3,8,8,260,0,260,241,19
"Echo township, Yellow Medicine County, Minnesota",82,80,0,0,0,0,2,82,2,80,82,0
"Florida township, Yellow Medicine County, Minnesota",128,128,0,0,0,0,0,128,0,128,128,0
"Fortier township, Yellow Medicine County, Minnesota",79,79,0,0,0,0,0,79,0,79,79,0
"Friendship township, Yellow Medicine County, Minnesota",205,205,12,0,0,0,0,205,2,203,193,12
"Granite Falls city, Yellow Medicine County, Minnesota",1945,1736,23,212,15,0,0,1945,215,1730,1904,41
"Hammer township, Yellow Medicine County, Minnesota",198,198,0,0,0,0,0,198,38,160,198,0
"Hanley Falls city, Yellow Medicine County, Minnesota",398,336,0,11,0,0,54,398,120,278,395,3
"Hazel Run city, Yellow Medicine County, Minnesota",32,32,0,0,0,0,0,32,0,32,32,0
"Hazel Run township, Yellow Medicine County, Minnesota",159,131,0,28,2,0,0,159,0,159,157,2
"Lisbon township, Yellow Medicine County, Minnesota",173,172,0,0,1,0,0,173,0,173,173,0
"Minnesota Falls township, Yellow Medicine County, Minnesota",369,216,14,184,3,0,2,369,2,367,328,41
"Norman township, Yellow Medicine County, Minnesota",208,208,0,0,0,0,0,208,0,208,208,0
"Normania township, Yellow Medicine County, Minnesota",223,217,0,0,6,0,0,223,7,216,223,0
"Omro township, Yellow Medicine County, Minnesota",61,61,0,0,0,0,0,61,0,61,61,0
"Oshkosh township, Yellow Medicine County, Minnesota",203,203,0,13,0,0,0,203,0,203,190,13
"Porter city, Yellow Medicine County, Minnesota",196,186,0,2,1,0,7,196,7,189,196,0
"Posen township, Yellow Medicine County, Minnesota",201,201,0,0,0,0,0,201,0,201,201,0
"St. Leo city, Yellow Medicine County, Minnesota",99,98,0,8,0,0,0,99,0,99,92,7
"Sandnes township, Yellow Medicine County, Minnesota",169,169,0,0,0,0,0,169,0,169,169,0
"Sioux Agency township, Yellow Medicine County, Minnesota",199,198,0,0,3,0,0,199,0,199,197,2
"Stony Run township, Yellow Medicine County, Minnesota",422,415,5,4,0,0,0,422,0,422,420,2
"Swede Prairie township, Yellow Medicine County, Minnesota",169,169,0,0,0,0,0,169,0,169,169,0
"Tyro township, Yellow Medicine County, Minnesota",181,181,0,0,0,0,0,181,0,181,181,0
"Wergeland township, Yellow Medicine County, Minnesota",174,174,0,0,0,0,0,174,0,174,174,0
"Wood Lake city, Yellow Medicine County, Minnesota",447,384,6,12,36,0,9,447,12,435,447,0
"Wood Lake township, Yellow Medicine County, Minnesota",298,294,4,0,0,0,0,298,1,297,298,0
